iloveguloseima1	iloveguloseima1	0
potededocuras	potededocuras	0
vivianegomes_cakes	vivianegomes_cakes	0
chicassp	chicassp	0
receitasfit_faceis	receitasfit_faceis	0
nocariritem	nocariritem	0
lechefgato	lechefgato	0
docedelicia_	docedelicia_	0
boldsnacks	boldsnacks	0
bru.nacozinha	bru.nacozinha	0
chefmarirezende	chefmarirezende	0
receita_fitnis	receita_fitnis	0
confeitariasaoluis	confeitariasaoluis	0
mariachocolatebh	mariachocolatebh	0
tamineelhajjdocesfinos	tamineelhajjdocesfinos	0
mariahelenabolos	mariahelenabolos	0
lullycandycorantes	lullycandycorantes	0
dengochocolates	dengochocolates	0
teretetenacozinha	teretetenacozinha	0
thecookieshop	thecookieshop	0
hot.pork	hot.pork	0
naminhapanela	naminhapanela	0
euamo_confeitar	euamo_confeitar	0
ateliethaisdohler	ateliethaisdohler	0
mundopaodoolivier	mundopaodoolivier	0
ideia.saudavel	ideia.saudavel	0
grasimoraiis	grasimoraiis	0
antoniomaciel.cakes	antoniomaciel.cakes	0
bestwheyoficial	bestwheyoficial	0
daniele_cakes_e_macarons	daniele_cakes_e_macarons	0
pontoapontoo	pontoapontoo	0
konjacmassa_mf	konjacmassa_mf	0
brigadeiria_bistro	brigadeiria_bistro	0
paonapanela	paonapanela	0
bolodepote.ofc	bolodepote.ofc	0
maternidadecolorida	maternidadecolorida	0
capitaoganchopizzaria	capitaoganchopizzaria	0
sorveteriaciadochocolate	sorveteriaciadochocolate	0
brumasdoceria	brumasdoceria	0
mariacacau_oficial	mariacacau_oficial	0
aquiemsantostem	aquiemsantostem	0
nutrissimaonline	nutrissimaonline	0
fedelfior	fedelfior	0
bolo.de.potinho.lucrativo	bolo.de.potinho.lucrativo	0
chefauricelioromao	chefauricelioromao	0
fernandayamao	fernandayamao	0
brigadeirosfabianadangelo	brigadeirosfabianadangelo	0
docemaria.ca	docemaria.ca	0
topcakesolutions	topcakesolutions	0
delikata	delikata	0
noeliadocessalgados	noeliadocessalgados	0
nayanecapistrano	nayanecapistrano	0
aquientrenos	aquientrenos	0
doces_perfeitos_	doces_perfeitos_	0
chefflaviasouza	chefflaviasouza	0
ultrafestbrasil	ultrafestbrasil	0
joaopizzaoficial	joaopizzaoficial	0
carmelcumbuco	carmelcumbuco	0
nataldicas	nataldicas	0
cozinha_basica	cozinha_basica	0
life_confeitaria	life_confeitaria	0
casalgarciabolos	casalgarciabolos	0
cozinhanervosa	cozinhanervosa	0
o_cantinho_da_de	o_cantinho_da_de	0
icechurrosoficial	icechurrosoficial	0
casadobiscoitooficial	casadobiscoitooficial	0
cozinhandosemgluten	cozinhandosemgluten	0
doceslila	doceslila	0
chef.bruna	chef.bruna	0
gourmetcozinha	gourmetcozinha	0
senhor_pudim	senhor_pudim	0
receitafitnapratica	receitafitnapratica	0
aguanabocasm	aguanabocasm	0
bettoauge	bettoauge	0
mastrellagoiania	mastrellagoiania	0
yeswecook	yeswecook	0
comidaeseducao	comidaeseducao	0
seu_churros	seu_churros	0
cybercookoficial	cybercookoficial	0
casinhachique	casinhachique	0
deliciasgourmett.1	deliciasgourmett.1	0
bruna_leite	bruna_leite	0
browniedoluiz	browniedoluiz	0
padariacostamendes	padariacostamendes	0
lilicakeart	lilicakeart	0
suspirando.merengues	suspirando.merengues	0
achadosedicasdacamis	achadosedicasdacamis	0
confeitariadoces_	confeitariadoces_	0
receitasfitecozinha	receitasfitecozinha	0
nossoapt	nossoapt	0
fabivianafv	fabivianafv	0
confeitariaroof	confeitariaroof	0
saudavel_erika	saudavel_erika	0
richesseconfeitaria	richesseconfeitaria	0
docegulaconfeitaria_	docegulaconfeitaria_	0
cadernetadereceitas	cadernetadereceitas	0
mundodaconfeitaria_oficial	mundodaconfeitaria_oficial	0
padocadoalex	padocadoalex	0
confeitariadesucessooficial	confeitariadesucessooficial	0
cozinhadapoly	cozinhadapoly	0
ateliecake	ateliecake	0
lillideechurros	lillideechurros	0
rafaelafontes_	rafaelafontes_	0
chefeduardobeltrame	chefeduardobeltrame	0
lacasacake	lacasacake	0
chefvandahering	chefvandahering	0
receitas_com_amor_oficial	receitas_com_amor_oficial	0
chefdarioheberson	chefdarioheberson	0
receitasdanastacia_	receitasdanastacia_	0
hilladoces	hilladoces	0
miguelitobolos	miguelitobolos	0
browniebrosbr	browniebrosbr	0
danielleandrade_sweet_and_cake	danielleandrade_sweet_and_cake	0
bistrodocesabor	bistrodocesabor	0
receitasdecomidafit	receitasdecomidafit	0
catupiryoficial	catupiryoficial	0
kitchenfordummies	kitchenfordummies	0
vizinhas013	vizinhas013	0
emporiobrownie	emporiobrownie	0
donamaricotaa	donamaricotaa	0
bolosdoflavio	bolosdoflavio	0
marigourmet	marigourmet	0
doce_e_arte	doce_e_arte	0
pikurruchas	pikurruchas	0
bauducco	bauducco	0
mangairestaurantes	mangairestaurantes	0
guladoces	guladoces	0
nat.mendonca	nat.mendonca	0
lemanjue	lemanjue	0
nestleprofessionalbr	nestleprofessionalbr	0
gelateriatrevo	gelateriatrevo	0
nolardarose	nolardarose	0
eu_preparo	eu_preparo	0
daniella.junqueira	daniella.junqueira	0
paolacakesconfeitaria	paolacakesconfeitaria	0
fitfood_ideas	fitfood_ideas	0
janainasuconic	janainasuconic	0
selecta.chocolates	selecta.chocolates	0
augurifestas	augurifestas	0
inesjunqueira	inesjunqueira	0
tiaverasouza	tiaverasouza	0
thigasribeiro	thigasribeiro	0
sicaochocolate	sicaochocolate	0
montaencanta	montaencanta	0
confeitaria_sucesso_	confeitaria_sucesso_	0
confeiteiradesucesso_curso	confeiteiradesucesso_curso	0
maisdicasfit	maisdicasfit	0
docesdaelsa_	docesdaelsa_	0
carolfortmuller	carolfortmuller	0
amopaocaseiro	amopaocaseiro	0
fascinanteconfeitaria	fascinanteconfeitaria	0
receitas_de_confeitaria_	receitas_de_confeitaria_	0
confeiteiraespecialista	confeiteiraespecialista	0
lowcarb_receitas_praticas_ofc	lowcarb_receitas_praticas_ofc	0
cantinhodoceuberlandia	cantinhodoceuberlandia	0
escoladebolo	escoladebolo	0
chefraissarr	chefraissarr	0
isamaraamancio	isamaraamancio	0
cantinho316	cantinho316	0
andreia_itacaramby	andreia_itacaramby	0
samiranunescake	samiranunescake	0
ondecomeremsalvador	ondecomeremsalvador	0
projetoconfeitaria	projetoconfeitaria	0
linhagranchef	linhagranchef	0
mundodosdoces	mundodosdoces	0
chefcristinahaaland	chefcristinahaaland	0
fitfoodmenu	fitfoodmenu	0
cozinhecomigo	cozinhecomigo	0
receitas_e_dicas_davovo	receitas_e_dicas_davovo	0
silviaribeirogourmet	silviaribeirogourmet	0
chefraquelnovais	chefraquelnovais	0
perdigao	perdigao	0
docedavidaconfeitaria	docedavidaconfeitaria	0
izaitensparaconfeitaria	izaitensparaconfeitaria	0
mundoda_confeitaria	mundoda_confeitaria	0
confeitaria_e_doceria_cursos	confeitaria_e_doceria_cursos	0
soreceitasdeliciosas	soreceitasdeliciosas	0
caparrozformas	caparrozformas	0
meumenu_	meumenu_	0
receitas_oficial_de_chocolate	receitas_oficial_de_chocolate	0
supermercadopinheirooficial	supermercadopinheirooficial	0
penelopeacademy	penelopeacademy	0
_minhacasinha	_minhacasinha	0
confeitariabrasil.com_	confeitariabrasil.com_	0
confeitaria_iniciantes	confeitaria_iniciantes	0
recheio_gostoso	recheio_gostoso	0
chocolatria_	chocolatria_	0
chocolife.br	chocolife.br	0
deliciaslowcarb	deliciaslowcarb	0
haraldchocolates	haraldchocolates	0
baciodilatte	baciodilatte	0
confeitaria_receitas_	confeitaria_receitas_	0
callebautbrasil	callebautbrasil	0
power1one	power1one	0
iceberg_chef	iceberg_chef	0
mixingredientes	mixingredientes	0
queroessadecor	queroessadecor	0
cooktopbrasil	cooktopbrasil	0
receitasaprenda	receitasaprenda	0
comer.com.br	comer.com.br	0
oquefazercuritiba	oquefazercuritiba	0
lowcarb_receitasfit	lowcarb_receitasfit	0
so_receitasfit_faceis	so_receitasfit_faceis	0
confeiteiras_prendadas	confeiteiras_prendadas	0
decorandobolo	decorandobolo	0
receita_doce_oficial	receita_doce_oficial	0
deliciasdaeleni	deliciasdaeleni	0
aprenda_docegourmet	aprenda_docegourmet	0
kitchenaidbrasil	kitchenaidbrasil	0
anaelisasalinas	anaelisasalinas	0
receitas.perfeitas	receitas.perfeitas	0
cozinhadonabenta	cozinhadonabenta	0
marianabritocakes	marianabritocakes	0
doce_gourmett_	doce_gourmett_	0
hailasantua_	hailasantua_	0
crispimichele	crispimichele	0
receitas_de_peso	receitas_de_peso	0
receitasfaceisdiarias	receitasfaceisdiarias	0
bolonopote.receita	bolonopote.receita	0
milk.churros	milk.churros	0
brastemp	brastemp	0
1001festas	1001festas	0
receitasdacris	receitasdacris	0
receitas.expert	receitas.expert	0
docesgourmet_2.0	docesgourmet_2.0	0
doces_gostosos_	doces_gostosos_	0
confeitandosemsegredos	confeitandosemsegredos	0
receitas_das_confeiteiras	receitas_das_confeiteiras	0
flakesbrasil	flakesbrasil	0
low.carb.mais	low.carb.mais	0
confeitandoedoces	confeitandoedoces	0
receitasdasboas	receitasdasboas	0
docesdadonabenta	docesdadonabenta	0
cozinhaecia.diario_	cozinhaecia.diario_	0
receiitafitness	receiitafitness	0
flormeloficial	flormeloficial	0
frutap	frutap	0
_heltonoliveira	_heltonoliveira	0
cozinhapanelinha	cozinhapanelinha	0
carlosbakerysp	carlosbakerysp	0
receberbem	receberbem	0
encontrodefestas	encontrodefestas	0
fitelowcarb_	fitelowcarb_	0
receitasdothales	receitasdothales	0
truquesedicasdare	truquesedicasdare	0
lowcarb_para_secar	lowcarb_para_secar	0
cozinhasaudaveldagra	cozinhasaudaveldagra	0
cozinhadavovoneuza	cozinhadavovoneuza	0
confeitaria_.doces	confeitaria_.doces	0
confeitarianarede	confeitarianarede	0
docesaudefit	docesaudefit	0
lowcarb.receitasrapidas	lowcarb.receitasrapidas	0
dicasdeconfeitariaoficial	dicasdeconfeitariaoficial	0
rainhadasreceitas	rainhadasreceitas	0
receitasdocesabor	receitasdocesabor	0
confeitariasemgeral	confeitariasemgeral	0
sigatudodeconfeitaria	sigatudodeconfeitaria	0
escoladaconfeitariaonline	escoladaconfeitariaonline	0
confeitaria_simples	confeitaria_simples	0
marianaperdomoconfeitaria	marianaperdomoconfeitaria	0
receitas_das_boas1	receitas_das_boas1	0
nutellabr	nutellabr	0
chocolatesbrasilcacau	chocolatesbrasilcacau	0
livupoficial	livupoficial	0
receitaslightoficial	receitaslightoficial	0
fitcomlowcarb	fitcomlowcarb	0
brissa	brissa	0
lutranchesi	lutranchesi	0
so.receitas_	so.receitas_	0
bolodepoteoficial__	bolodepoteoficial__	0
receitasnestle	receitasnestle	0
panelaterapia	panelaterapia	0
chefleoliveira	chefleoliveira	0
luanaagomesc	luanaagomesc	0
chefekadubarros	chefekadubarros	0
_receitas_faceis_	_receitas_faceis_	0
livro_de_receitas_	livro_de_receitas_	0
o.segredo.da.vovo	o.segredo.da.vovo	0
receitasfitelowcarb	receitasfitelowcarb	0
loucaporfestas	loucaporfestas	0
guiadacozinha	guiadacozinha	0
receitasdicasfit	receitasdicasfit	0
_bolodepoteofc_	_bolodepoteofc_	1
_lowcarbemagrece_	_lowcarbemagrece_	1
andreia_itacaramby	andreia_itacaramby	1
aquitemreceitaoficial	aquitemreceitaoficial	1
asdelicias_da_vovo	asdelicias_da_vovo	1
atelie_divertidamente_doces	atelie_divertidamente_doces	1
aulasdereceitasfit	aulasdereceitasfit	1
biameloconfeitaria	biameloconfeitaria	1
blog_melepimenta	blog_melepimenta	1
bolos_receitas_maravilhosas	bolos_receitas_maravilhosas	1
bolosedoces_sempre	bolosedoces_sempre	1
bolosedocesofi	bolosedocesofi	1
boloslindos_cf	boloslindos_cf	1
brigadeirogourmet_ofc	brigadeirogourmet_ofc	1
cakeshopbr	cakeshopbr	1
carolecrema	carolecrema	1
chantininhooficial	chantininhooficial	1
chefeduardobeltrame	chefeduardobeltrame	1
chefgugarocha	chefgugarocha	1
chefjanainabarzanelli	chefjanainabarzanelli	1
chocolate_gourmet2019	chocolate_gourmet2019	1
confeitaria.com.amor_	confeitaria.com.amor_	1
confeitaria_passo_a_passo_	confeitaria_passo_a_passo_	1
confeitariasemgeral	confeitariasemgeral	1
daniele_cakes_e_macarons	daniele_cakes_e_macarons	1
dietalowcarbsaudavel	dietalowcarbsaudavel	1
dietasdesucesso	dietasdesucesso	1
doceconfeitariacriativa	doceconfeitariacriativa	1
doceinvestimento	doceinvestimento	1
doceria.gourmeet	doceria.gourmeet	1
docesinfaliveis	docesinfaliveis	1
duasxdoce	duasxdoce	1
emagrecendobrasil_	emagrecendobrasil_	1
erickjacquin	erickjacquin	1
escoladaconfeitariaonline	escoladaconfeitariaonline	1
escoladeconfeitar	escoladeconfeitar	1
eu_preparo	eu_preparo	1
fabivianafv	fabivianafv	1
foodmakersbr	foodmakersbr	1
gabriellfreitass	gabriellfreitass	1
geminamorelato	geminamorelato	1
habitos_.saudaveis	habitos_.saudaveis	1
haraldchocolates	haraldchocolates	1
igorochaoficial	igorochaoficial	1
incrivel.oficial	incrivel.oficial	1
inspiracupcakes	inspiracupcakes	1
isamarltda	isamarltda	1
izaitensparaconfeitaria	izaitensparaconfeitaria	1
la_casa_da_confeitaria	la_casa_da_confeitaria	1
linhagranchef	linhagranchef	1
lowcarb.comprazer	lowcarb.comprazer	1
lowcarb.receitasfit_	lowcarb.receitasfit_	1
lowcarb.receitasrapidas	lowcarb.receitasrapidas	1
lowcarb_e_receitas_defamilia	lowcarb_e_receitas_defamilia	1
lowcarb_e_receitasfitness	lowcarb_e_receitasfitness	1
lowcarb_para_secar	lowcarb_para_secar	1
lowcarb_receitas_praticas_ofc	lowcarb_receitas_praticas_ofc	1
lowcarb_reeceitas	lowcarb_reeceitas	1
lowcarbb.simples	lowcarbb.simples	1
lowcarbereceitasfitness	lowcarbereceitasfitness	1
lowcarbreceitaa	lowcarbreceitaa	1
lucas_piubelli_	lucas_piubelli_	1
luciliadiniz	luciliadiniz	1
lucrandocomaconfeitaria	lucrandocomaconfeitaria	1
ma.confeitaria	ma.confeitaria	1
mariliacalacio	mariliacalacio	1
meireoscar	meireoscar	1
montaencanta	montaencanta	1
mundoda_confeitaria	mundoda_confeitaria	1
nossareceitabr	nossareceitabr	1
panelaterapia	panelaterapia	1
paraisodasconfeiteiras_oficial	paraisodasconfeiteiras_oficial	1
paulamellocakedesigner	paulamellocakedesigner	1
penelopeacademy	penelopeacademy	1
perderbarrigaofficial	perderbarrigaofficial	1
pgmchefsemacaooficial	pgmchefsemacaooficial	1
programasantareceitaoficial	programasantareceitaoficial	1
projetoconfeitaria	projetoconfeitaria	1
rainhadasreceitas	rainhadasreceitas	1
receita_da_lilica	receita_da_lilica	1
receita_do_dia_dia	receita_do_dia_dia	1
receita_fitnis	receita_fitnis	1
receitadajoice	receitadajoice	1
receitapraticas	receitapraticas	1
receitas.boas_saudaveis	receitas.boas_saudaveis	1
receitas.darose	receitas.darose	1
receitas.expert	receitas.expert	1
receitas.faceisdemais	receitas.faceisdemais	1
receitas.fitness.2.0	receitas.fitness.2.0	1
receitas.fitness.emcasa	receitas.fitness.emcasa	1
receitas.fitness_aqui	receitas.fitness_aqui	1
receitas.lowcarb_e_dicas	receitas.lowcarb_e_dicas	1
receitas.perfeitas	receitas.perfeitas	1
receitas__gostosas__	receitas__gostosas__	1
receitas__originais	receitas__originais	1
receitas_com_amor_oficial	receitas_com_amor_oficial	1
receitas_da_amanda	receitas_da_amanda	1
receitas_da_sonia	receitas_da_sonia	1
receitas_deliciosas_da_casa	receitas_deliciosas_da_casa	1
receitas_do_confeiteiro	receitas_do_confeiteiro	1
receitas_dona_benta2	receitas_dona_benta2	1
receitas_e_dicas_davovo	receitas_e_dicas_davovo	1
receitas_na_cozinha	receitas_na_cozinha	1
receitasboaa	receitasboaa	1
receitascomamor.ofc	receitascomamor.ofc	1
receitascomvovo	receitascomvovo	1
receitasdadonafatima	receitasdadonafatima	1
receitasdochefe.ofc	receitasdochefe.ofc	1
receitasdoedy	receitasdoedy	1
receitasfaceisnapratica	receitasfaceisnapratica	1
receitasfiits	receitasfiits	1
receitasfit.simples_	receitasfit.simples_	1
receitasfitdeliciosass_	receitasfitdeliciosass_	1
receitasfitness_saudaveis_	receitasfitness_saudaveis_	1
receitasfitnocapricho_	receitasfitnocapricho_	1
receitasfits_ofc	receitasfits_ofc	1
receiteifit	receiteifit	1
receituandomaster	receituandomaster	1
recheiosdiarios	recheiosdiarios	1
s2.bolo	s2.bolo	1
samiranunescake	samiranunescake	1
secando.de.vez	secando.de.vez	1
secrets.culinary	secrets.culinary	1
sigalowcarbereceitasfit	sigalowcarbereceitasfit	1
sigatudodeconfeitaria	sigatudodeconfeitaria	1
sococobrasil	sococobrasil	1
supercriativoo	supercriativoo	1
tathifabulosa	tathifabulosa	1
tutorialdedoces	tutorialdedoces	1
viver_da_confeitaria	viver_da_confeitaria	1
bolodepoteoficial__	bolodepoteoficial__	1
camilamasullo	camilamasullo	1
ComidasDeliciosasOficial	ComidasDeliciosasOficial	1
confeitandosemsegredos	confeitandosemsegredos	1
confeitaria_receitas_	confeitaria_receitas_	1
confeitaria_simples	confeitaria_simples	1
confeitariaa._	confeitariaa._	1
confeiteiras_prendadas	confeiteiras_prendadas	1
docesgourmet_2.0	docesgourmet_2.0	1
emagrecer.e.secar_barriga	emagrecer.e.secar_barriga	1
emagrecercomendobem_	emagrecercomendobem_	1
imperioreceita	imperioreceita	1
receitas.faceis.oficial	receitas.faceis.oficial	1
receitas.pra.voce	receitas.pra.voce	1
receitas_das_confeiteiras	receitas_das_confeiteiras	1
receitas_do_chef_	receitas_do_chef_	1
receitas_e_dicas_oficial	receitas_e_dicas_oficial	1
receitas_fitness_online	receitas_fitness_online	1
receitas_mais.saudaveis	receitas_mais.saudaveis	1
receitasdamagali	receitasdamagali	1
receitasdothales	receitasdothales	1
receitasedicasdevoof	receitasedicasdevoof	1
receitasetruquesdolar	receitasetruquesdolar	1
receitasfaceissoficial	receitasfaceissoficial	1
receitasfit.tododia19	receitasfit.tododia19	1
receitasnestle	receitasnestle	1
so.receitas_	so.receitas_	1
tudonacozinhaofc	tudonacozinhaofc	1
canalandreresende	canalandreresende	1
canalvidadecasados	canalvidadecasados	1
chefluzineteveiga	chefluzineteveiga	1
chefsilvianicolau	chefsilvianicolau	1
com_partilhando	com_partilhando	1
cozinhaamiga	cozinhaamiga	1
deliciasdaeleni	deliciasdaeleni	1
ericamorilo	ericamorilo	1
escoladesalgados	escoladesalgados	1
fab.ind	fab.ind	1
ilnadejorge	ilnadejorge	1
lookdofogao	lookdofogao	1
mesaharmoniosa	mesaharmoniosa	1
oficialbaudasdicas	oficialbaudasdicas	1
patriciahopf	patriciahopf	1
priconfeiteira	priconfeiteira	1
receitasdacris	receitasdacris	1
receitasdonadirce	receitasdonadirce	1
receitasetemperos	receitasetemperos	1
silviabranconaro	silviabranconaro	1
tabataromeroo	tabataromeroo	1
tpmjuferraz	tpmjuferraz	1
vitorcorrea13	vitorcorrea13	1
amantesdacozinhaoficial	amantesdacozinhaoficial	1
aquelareceita	aquelareceita	1
arte2irmaos	arte2irmaos	1
cozinhadanayoficial	cozinhadanayoficial	1
cucachef	cucachef	1
receitaefacil	receitaefacil	1
receitasdatitiaoficial	receitasdatitiaoficial	1
receitasdavolurdes	receitasdavolurdes	1
receitasdepai	receitasdepai	1
receitasnanetoficial	receitasnanetoficial	1
receitasshowdebola	receitasshowdebola	1
_mavalerio	_mavalerio	1
acervopanelinha	acervopanelinha	1
alexgranigfit	alexgranigfit	1
amourducake	amourducake	1
aprenda_docegourmet	aprenda_docegourmet	1
artedeconfeiteira	artedeconfeiteira	1
bolodepotelucrativo_	bolodepotelucrativo_	1
bolos.maravilhosos_	bolos.maravilhosos_	1
bolos_em_pratica_	bolos_em_pratica_	1
bolos_na_pratica_	bolos_na_pratica_	1
bolosereceitaas	bolosereceitaas	1
bolosnopotee_	bolosnopotee_	1
boutiquedoconfeiteiro	boutiquedoconfeiteiro	1
bru.nacozinha	bru.nacozinha	1
cakes_brasil_oficial	cakes_brasil_oficial	1
callebautbrasil	callebautbrasil	1
canal_babi_oficial	canal_babi_oficial	1
cantinho_da_tati_	cantinho_da_tati_	1
cantinhodocesgourmet_	cantinhodocesgourmet_	1
cardapiofito	cardapiofito	1
carlapernambucocarlota	carlapernambucocarlota	1
carolfiorentino	carolfiorentino	1
casavovopalmirinha	casavovopalmirinha	1
celsoportiolli	celsoportiolli	1
chefclubbrasil	chefclubbrasil	1
chefcristinahaaland	chefcristinahaaland	1
chefeanacosta	chefeanacosta	1
chefjuliocruzoficial	chefjuliocruzoficial	1
cheflucascorazza	cheflucascorazza	1
ciadomolde	ciadomolde	1
ciauniao	ciauniao	1
cidinha_santiago	cidinha_santiago	1
confeitandoedoces	confeitandoedoces	1
confeitaria.de.sucesso_	confeitaria.de.sucesso_	1
confeitaria.onlinee_	confeitaria.onlinee_	1
confeitaria.profissional_	confeitaria.profissional_	1
confeitaria_.doces	confeitaria_.doces	1
confeitaria_cursos	confeitaria_cursos	1
confeitaria_e_doceria_cursos	confeitaria_e_doceria_cursos	1
confeitaria_incrivel	confeitaria_incrivel	1
confeitaria_nivel_alto	confeitaria_nivel_alto	1
confeitaria_sucesso_	confeitaria_sucesso_	1
confeitariabrasil.com_	confeitariabrasil.com_	1
confeitariado.momento	confeitariado.momento	1
confeitariadoces_	confeitariadoces_	1
confeitarialucrativa5.0	confeitarialucrativa5.0	1
confeitarialucrativas_	confeitarialucrativas_	1
confeitariameiga	confeitariameiga	1
confeitarianarede	confeitarianarede	1
confeitariarica	confeitariarica	1
confeitarporamor_	confeitarporamor_	1
confeiteiradesucesso_curso	confeiteiradesucesso_curso	1
confeiteiradesucessofc	confeiteiradesucessofc	1
confeiteiraespecialista	confeiteiraespecialista	1
confeiteirafeh	confeiteirafeh	1
confeiteiramaster	confeiteiramaster	1
contemonline	contemonline	1
cozinha_basica	cozinha_basica	1
cozinhadakeite	cozinhadakeite	1
cozinhadonabenta	cozinhadonabenta	1
cozinhapanelinha	cozinhapanelinha	1
cozinhatododia	cozinhatododia	1
cupcakelucrar	cupcakelucrar	1
curso.bolo.no.pote.gourmet	curso.bolo.no.pote.gourmet	1
curso.doce.gourmeet	curso.doce.gourmeet	1
curso_doces_gourmeet	curso_doces_gourmeet	1
cursogordicesdadeiabolos	cursogordicesdadeiabolos	1
cybercookoficial	cybercookoficial	1
daianacaldeiraatelie	daianacaldeiraatelie	1
danielabolos	danielabolos	1
decorandobolo	decorandobolo	1
deixacomanutrioficial	deixacomanutrioficial	1
deliciasgourmett.1	deliciasgourmett.1	1
detox.eficaz	detox.eficaz	1
detox30dias7	detox30dias7	1
dicasfitoficial	dicasfitoficial	1
dieta_e_receitas_emagrecer	dieta_e_receitas_emagrecer	1
dietadetox77	dietadetox77	1
doce_confeitaria_	doce_confeitaria_	1
doce_gourmett_	doce_gourmett_	1
doceinspiracaodoce	doceinspiracaodoce	1
docelardanina	docelardanina	1
doces_brasil_boss	doces_brasil_boss	1
doces_fantastico	doces_fantastico	1
docesgourmet_top	docesgourmet_top	1
droetkerbrasil	droetkerbrasil	1
emagrecer.comendo.bem	emagrecer.comendo.bem	1
emagrecerdetoxreceitas	emagrecerdetoxreceitas	1
emagrecerpermanente__	emagrecerpermanente__	1
estefanozaquini	estefanozaquini	1
fanclubfab	fanclubfab	1
fascinanteconfeitaria	fascinanteconfeitaria	1
fegourmetacademy	fegourmetacademy	1
fernandayamao	fernandayamao	1
fitereceitas	fitereceitas	1
flamboesa	flamboesa	1
foodnetworkbr	foodnetworkbr	1
franciulli14	franciulli14	1
goriahuk	goriahuk	1
gourmetizaoseudia	gourmetizaoseudia	1
iceberg_chef	iceberg_chef	1
iloveguloseima1	iloveguloseima1	1
irmaosnacozinha	irmaosnacozinha	1
isamaraamancio	isamaraamancio	1
jantinhadehoje	jantinhadehoje	1
low.carb.mais	low.carb.mais	1
lowcarb_comidasfit	lowcarb_comidasfit	1
lowcarb_receitas_	lowcarb_receitas_	1
lukeandcook	lukeandcook	1
magoindustria	magoindustria	1
maizenabrasil	maizenabrasil	1
mandiocaecaviar	mandiocaecaviar	1
marceloynagata	marceloynagata	1
marciasuzukipatisserie	marciasuzukipatisserie	1
marrarabortoloti7	marrarabortoloti7	1
masterchefbr	masterchefbr	1
meninoprendado	meninoprendado	1
mixingredientes	mixingredientes	1
naijabakers247	naijabakers247	1
naminhapanela	naminhapanela	1
nestleprofessionalbr	nestleprofessionalbr	1
nutricionistajanainacampos	nutricionistajanainacampos	1
osmelhoresbolosdomundo	osmelhoresbolosdomundo	1
pameladomingues	pameladomingues	1
portalconfeitariasimples	portalconfeitariasimples	1
portoformas	portoformas	1
projetofit60dias_aqui	projetofit60dias_aqui	1
receiitas_saudaveiss	receiitas_saudaveiss	1
receitas.boas.ofiicial	receitas.boas.ofiicial	1
receitas.faceis.br	receitas.faceis.br	1
receitas.fenomenicas	receitas.fenomenicas	1
receitas.gostosaas	receitas.gostosaas	1
receitas.gourmte	receitas.gourmte	1
receitas.lowcarb.secar	receitas.lowcarb.secar	1
receitas_boa	receitas_boa	1
receitas_fitsaudaveis_	receitas_fitsaudaveis_	1
receitas_oficial_de_chocolate	receitas_oficial_de_chocolate	1
receitas_prontas1.7	receitas_prontas1.7	1
receitas_superdeliciosas	receitas_superdeliciosas	1
receitasbasicas_fit	receitasbasicas_fit	1
receitasdecomidafit	receitasdecomidafit	1
receitasfit_faceis	receitasfit_faceis	1
receitasfitnoinsta	receitasfitnoinsta	1
receitasquedelicias	receitasquedelicias	1
reeducacaoalimentar3.0	reeducacaoalimentar3.0	1
selecta.chocolates	selecta.chocolates	1
servidos	servidos	1
sigambolosdecorados	sigambolosdecorados	1
so_receitasfit_faceis	so_receitasfit_faceis	1
tanamesa.tm	tanamesa.tm	1
tastymolds	tastymolds	1
temperodavovo0	temperodavovo0	1
teretetenacozinha	teretetenacozinha	1
thabatagasperi	thabatagasperi	1
thecookieshop	thecookieshop	1
truquesedicasdare	truquesedicasdare	1
vida_fitnesz	vida_fitnesz	1
vix.yum.brasil	vix.yum.brasil	1
vovozinha_das_receitas	vovozinha_das_receitas	1
wecelebratecakes	wecelebratecakes	1
_receitas_faceis_	_receitas_faceis_	1
_receitasdavovolurdes	_receitasdavovolurdes	1
alexgranig	alexgranig	1
areceitaria	areceitaria	1
bolonopote.receita	bolonopote.receita	1
bolos_e_receitas_para_voce_	bolos_e_receitas_para_voce_	1
chefleoliveira	chefleoliveira	1
cooknenjoy	cooknenjoy	1
culinariaemcasaoficial	culinariaemcasaoficial	1
dikadanaka	dikadanaka	1
doces_gostosos_	doces_gostosos_	1
euamo_confeitar	euamo_confeitar	1
exerciciosemcasa.e.emagrecer	exerciciosemcasa.e.emagrecer	1
fitcom_receitasedicas_	fitcom_receitasedicas_	1
guiadacozinha	guiadacozinha	1
nhacgnt	nhacgnt	1
portaldasreceitasoficial	portaldasreceitasoficial	1
receitas_das_boas1	receitas_das_boas1	1
receitas_de_peso	receitas_de_peso	1
receitas_e_praticas	receitas_e_praticas	1
receitasaprenda	receitasaprenda	1
receitasdatiasheila	receitasdatiasheila	1
receitasdavovonair	receitasdavovonair	1
receitasfaceisdiarias	receitasfaceisdiarias	1
receitasfaceisoficial	receitasfaceisoficial	1
receitasfiitness	receitasfiitness	1
sigamundodosbolos	sigamundodosbolos	1
soreceitasdeliciosas	soreceitasdeliciosas	1
tastemadebr	tastemadebr	1
tastydemais	tastydemais	1
topcozinhaa	topcozinhaa	1
tudogostosooficial	tudogostosooficial	1
vovopalmirinha	vovopalmirinha	1
esposavirtuosa	esposavirtuosa	1
receitaslowcarbfit_	receitaslowcarbfit_	1
curso.confeiteiraprofissional	curso.confeiteiraprofissional	1
docesdadonabenta	docesdadonabenta	1
docesdaelsa_	docesdaelsa_	1
emagrecer.com.receitas	emagrecer.com.receitas	1
low.carb.facill	low.carb.facill	1
receitas_simples_oficial	receitas_simples_oficial	1
receitasfiitoficial_	receitasfiitoficial_	1
receitasfitfacil_	receitasfitfacil_	1
receitasdoces_deliciosas	receitasdoces_deliciosas	1
alessandratorres_oficial	alessandratorres_oficial	1
amenidades_de_kelly	amenidades_de_kelly	1
ameyummycollection	ameyummycollection	1
aquelacomidaofc	aquelacomidaofc	1
cakebakeoffngofficial	cakebakeoffngofficial	1
cakebrasil_oficial	cakebrasil_oficial	1
cakeideasfoto	cakeideasfoto	1
cakes_world_beauty	cakes_world_beauty	1
chef_jurandyr_affonso	chef_jurandyr_affonso	1
coisasdemulheres.jerusa	coisasdemulheres.jerusa	1
confeitaria.e.ciia	confeitaria.e.ciia	1
confeitaria_aprendavocemesma_	confeitaria_aprendavocemesma_	1
cozinha_da_fabih	cozinha_da_fabih	1
cozinha_sem_frescura	cozinha_sem_frescura	1
cozinhadacris_	cozinhadacris_	1
cozinhadapoly	cozinhadapoly	1
cozinhanervosa	cozinhanervosa	1
dicasparaemagrecercomsaude	dicasparaemagrecercomsaude	1
dietando.online	dietando.online	1
dikasereceitas.vip	dikasereceitas.vip	1
doces_perfeitos_	doces_perfeitos_	1
emagrecendocomliberdade	emagrecendocomliberdade	1
emagrecer.rapido.pro	emagrecer.rapido.pro	1
fatimaa_machado	fatimaa_machado	1
guiadereceitasbr	guiadereceitasbr	1
inspira.reh	inspira.reh	1
jessicaaraujo_oliveira	jessicaaraujo_oliveira	1
mimiminacozinha	mimiminacozinha	1
mundodocedamarii	mundodocedamarii	1
nandap_carneiro	nandap_carneiro	1
neuroticmom	neuroticmom	1
oficialmarrarabortoloti1	oficialmarrarabortoloti1	1
ohhgourmet	ohhgourmet	1
plataforma_emagrecimento	plataforma_emagrecimento	1
recebercomcharme	recebercomcharme	1
receiitafitness	receiitafitness	1
receitas_caseiras_da_mae	receitas_caseiras_da_mae	1
receitas_oficial	receitas_oficial	1
receitasdasboas	receitasdasboas	1
receitasfacil_epraticas	receitasfacil_epraticas	1
receitasfit_online	receitasfit_online	1
robertoaugustoculinaria	robertoaugustoculinaria	1
robertostrongoli	robertostrongoli	1
rozhe.cake	rozhe.cake	1
supergostosoo	supergostosoo	1
amorporeceitas	amorporeceitas	1
confeitaria.da.mamae_	confeitaria.da.mamae_	1
cozinhadamaria.oficial	cozinhadamaria.oficial	1
cozinhadatataoficial	cozinhadatataoficial	1
cozinhadochefee	cozinhadochefee	1
cozinhaecia.diario_	cozinhaecia.diario_	1
dicasdacriss	dicasdacriss	1
dicasnapratica	dicasnapratica	1
livro_de_receitas_	livro_de_receitas_	1
o.segredo.da.vovo	o.segredo.da.vovo	1
receita_doce_oficial	receita_doce_oficial	1
receitas_da_internet	receitas_da_internet	1
receitasdeliciosas1_	receitasdeliciosas1_	1
receitasdeliciosasdavovo0	receitasdeliciosasdavovo0	1
receitasdocesabor	receitasdocesabor	1
receitasdodeco	receitasdodeco	1
gian_eidler	gian_eidler	1
guiacapixaba	guiacapixaba	1
restauranteaoyama	restauranteaoyama	1
gastroetcetal	gastroetcetal	1
restauranteema	restauranteema	1
gastronomizei	gastronomizei	1
carmelitagastronomia	carmelitagastronomia	1
chrisparkhotel	chrisparkhotel	1
dietaflexivel	dietaflexivel	1
nutrijoaomuzzy	nutrijoaomuzzy	1
marcosbalda	marcosbalda	1
omundonacozinha	omundonacozinha	1
marques.lilo	marques.lilo	1
floripa2go	floripa2go	1
mundoculinaria	mundoculinaria	1
lowcarb.receitafit	lowcarb.receitafit	1
dicas_para.emagrecer	dicas_para.emagrecer	1
comproseuveiculo	comproseuveiculo	1
luanaafalcao	luanaafalcao	1
alhoecebola	alhoecebola	1
hotelfazendavalereal	hotelfazendavalereal	1
emagrecendoemjejum	emagrecendoemjejum	1
nomoo	nomoo	1
stoneinbox	stoneinbox	1
carneirodoordonespioneiro	carneirodoordonespioneiro	1
_oalemao	_oalemao	1
milwaukeeamericanbar	milwaukeeamericanbar	1
chefmichaelmiranda_lowcarb	chefmichaelmiranda_lowcarb	1
espetinhos_gourmet_	espetinhos_gourmet_	1
toysushi	toysushi	1
foodse.com.br	foodse.com.br	1
breadmakerbrasil	breadmakerbrasil	1
pizzaforfunoficial	pizzaforfunoficial	1
bbqemcasabh	bbqemcasabh	1
comarellapizzaeburger	comarellapizzaeburger	1
nutrifresh	nutrifresh	1
emporiofrutaria	emporiofrutaria	1
projetocomer	projetocomer	1
pousadaestanciarural	pousadaestanciarural	1
rodeiotube	rodeiotube	1
praianobar	praianobar	1
lowcarbb_brasil	lowcarbb_brasil	1
casadoarrozfrito	casadoarrozfrito	1
elshaddai_gourmet	elshaddai_gourmet	1
jader.burguer	jader.burguer	1
ondeirbc	ondeirbc	1
cadorecuritiba	cadorecuritiba	1
imperiobbq	imperiobbq	1
aragonrestaurante	aragonrestaurante	1
fogocampeiro	fogocampeiro	1
cantinhodofaustinothe	cantinhodofaustinothe	1
receitas_sejafit.lowcarb	receitas_sejafit.lowcarb	1
tupperware_inn	tupperware_inn	1
dr.lanza_nutri	dr.lanza_nutri	1
caiosoter	caiosoter	1
paulasalles1	paulasalles1	1
hamburgeiros	hamburgeiros	1
restaurantedonsabata	restaurantedonsabata	1
ochurrasco_perfeito	ochurrasco_perfeito	1
annietshirt	annietshirt	1
thibotelho_	thibotelho_	1
docevegana	docevegana	1
bite_oficial	bite_oficial	1
nutripaladar	nutripaladar	1
amazonsushi_	amazonsushi_	1
villagepizzaria	villagepizzaria	1
comidinhas	comidinhas	1
mirantedasaguasmt	mirantedasaguasmt	1
delihcia	delihcia	1
nutricionistarafaelamold	nutricionistarafaelamold	1
chefraphavasconcellos	chefraphavasconcellos	1
pousadabgk	pousadabgk	1
saboresdacidade	saboresdacidade	1
comandantegeralrestaurante	comandantegeralrestaurante	1
marmitas_marista	marmitas_marista	1
fabianamelonutri	fabianamelonutri	1
wasabisushifood	wasabisushifood	1
andre_exobeso23kg_off	andre_exobeso23kg_off	1
euamocamposdojordao	euamocamposdojordao	1
aondeiremsp	aondeiremsp	1
boigordogoias	boigordogoias	1
espacopuravida	espacopuravida	1
revistadeguste	revistadeguste	1
alessandroeller	alessandroeller	1
bbqemcasa	bbqemcasa	1
kitagawa_sushi	kitagawa_sushi	1
homechefsbr	homechefsbr	1
pipo_sp	pipo_sp	1
chefmalulobo	chefmalulobo	1
apartamentopequeno	apartamentopequeno	1
petiscosdasmeninas	petiscosdasmeninas	1
melchiorchef	melchiorchef	1
royalgourmet	royalgourmet	1
lowcarb_ja	lowcarb_ja	1
nutriangelicapadilha	nutriangelicapadilha	1
carnedesol1008	carnedesol1008	1
plabaki	plabaki	1
cozinheja	cozinheja	1
top_saopaulo_restaurants	top_saopaulo_restaurants	1
vielagastronomica	vielagastronomica	1
consultoradealimentos	consultoradealimentos	1
acaimagnifico	acaimagnifico	1
lechefdelivery	lechefdelivery	1
nutricionistacamille	nutricionistacamille	1
iolandaevelin	iolandaevelin	1
gilbertoelkis	gilbertoelkis	1
adegasantiago	adegasantiago	1
bendita_horta	bendita_horta	1
mahalocozinhacriativa	mahalocozinhacriativa	1
gastronomiaemnatal	gastronomiaemnatal	1
jpsteakhousegoiania	jpsteakhousegoiania	1
graoculinariasaudavel	graoculinariasaudavel	1
vovovegana	vovovegana	1
ficavaiterjanta	ficavaiterjanta	1
lojacasaribeiro	lojacasaribeiro	1
gurume_oficial	gurume_oficial	1
cheesehousebr	cheesehousebr	1
broburgersp	broburgersp	1
nutrilomariofonseca	nutrilomariofonseca	1
tembiopora	tembiopora	1
feedbrasil	feedbrasil	1
chavesparaomundo	chavesparaomundo	1
zencomidajaponesa	zencomidajaponesa	1
sionburguer	sionburguer	1
culinaria.davan	culinaria.davan	1
tiaizafit	tiaizafit	1
nutrifysaude	nutrifysaude	1
aziladosoficial	aziladosoficial	1
restaurantecastelli	restaurantecastelli	1
lamonnyel	lamonnyel	1
brucalderon	brucalderon	1
pitacosdocasal	pitacosdocasal	1
restaurantecapimsanto	restaurantecapimsanto	1
hoteisfazendaembrasilia	hoteisfazendaembrasilia	1
nativasgrillgoiania	nativasgrillgoiania	1
reidascarnespb	reidascarnespb	1
deliciasdatia	deliciasdatia	1
churrasconobafo	churrasconobafo	1
porteiravelha	porteiravelha	1
ticianawerner	ticianawerner	1
pizzadorao	pizzadorao	1
lowcarb.receitas.oficiial	lowcarb.receitas.oficiial	1
100foods	100foods	1
laranatacci	laranatacci	1
fogoechama	fogoechama	1
projetoneneca	projetoneneca	1
guiacomida	guiacomida	1
marinagorga.nutri	marinagorga.nutri	1
paradorhampel	paradorhampel	1
babybeef_bh	babybeef_bh	1
kakoburguers	kakoburguers	1
slowfood.brasil	slowfood.brasil	1
viagemcombagagemblog	viagemcombagagemblog	1
wal.untar	wal.untar	1
vegetarianasincera	vegetarianasincera	1
oateliedeceramica	oateliedeceramica	1
recomendoembsb	recomendoembsb	1
pegaadica	pegaadica	1
nutricionistabernardomaia	nutricionistabernardomaia	1
donabrancajpoficial	donabrancajpoficial	1
camposcompati	camposcompati	1
kamilipiccoli	kamilipiccoli	1
daniperosa	daniperosa	1
sandinsano	sandinsano	1
lanchonetedacidade	lanchonetedacidade	1
alacarne.dryaged	alacarne.dryaged	1
alimentarcarnesnobres	alimentarcarnesnobres	1
duogourmet	duogourmet	1
bodinhobarretos	bodinhobarretos	1
sampaburgeroficial	sampaburgeroficial	1
semfrescuraburger	semfrescuraburger	1
zedohamburger	zedohamburger	1
bbeleaf	bbeleaf	1
fm.fitmeals	fm.fitmeals	1
emagrecer_perdergordura	emagrecer_perdergordura	1
mandapicanha	mandapicanha	1
masterprimecarnes	masterprimecarnes	1
porcaobh	porcaobh	1
nossolugar2016	nossolugar2016	1
recife_indica	recife_indica	1
popveganfood	popveganfood	1
rascalrestaurante	rascalrestaurante	1
corgastronomia	corgastronomia	1
lowcarb_70receitas	lowcarb_70receitas	1
revistavegetarianos	revistavegetarianos	1
sensacaodoacai	sensacaodoacai	1
carneschurrascos	carneschurrascos	1
cristian_bauer	cristian_bauer	1
vikings.br	vikings.br	1
bhcomidaria	bhcomidaria	1
goianiaindica	goianiaindica	1
domdivinogourmetbh	domdivinogourmetbh	1
fogocampeiroteresina	fogocampeiroteresina	1
gastronomiacaruaru	gastronomiacaruaru	1
butchers746	butchers746	1
melanylolee	melanylolee	1
veganosnapratica	veganosnapratica	1
orgbistro	orgbistro	1
onburg	onburg	1
madalenagastrobar	madalenagastrobar	1
gastromotiva	gastromotiva	1
autenticatshirt	autenticatshirt	1
andre.rochadel	andre.rochadel	1
maxdavid	maxdavid	1
gigiazevedo	gigiazevedo	1
macaxeirarestaurante	macaxeirarestaurante	1
bbqsecrets	bbqsecrets	1
restaurantweekbrasil	restaurantweekbrasil	1
carnesboiverde	carnesboiverde	1
pizzariaatlantico	pizzariaatlantico	1
alemdomenu	alemdomenu	1
charadaburguer_abc	charadaburguer_abc	1
acouguevegano	acouguevegano	1
chefdanielbarbosa	chefdanielbarbosa	1
nutrirobertof	nutrirobertof	1
zuccorestaurante	zuccorestaurante	1
farturabrasil	farturabrasil	1
omundodascoxinhas	omundodascoxinhas	1
sigadietasaude	sigadietasaude	1
dicasdovarella	dicasdovarella	1
muller_nutri	muller_nutri	1
theburgerstorebr	theburgerstorebr	1
receitas_e_dicas_fit1	receitas_e_dicas_fit1	1
restaurantejangada	restaurantejangada	1
chefanazambelli	chefanazambelli	1
carneanguscertificada	carneanguscertificada	1
imprensafoodsquareoficial	imprensafoodsquareoficial	1
texanopicanharia	texanopicanharia	1
amorasaboreslight	amorasaboreslight	1
valedosvinhedosoficial	valedosvinhedosoficial	1
ttroisgros	ttroisgros	1
vempracazolla	vempracazolla	1
feserpa	feserpa	1
comidainvisivel	comidainvisivel	1
abbracciorestaurante	abbracciorestaurante	1
saboresetemperos	saboresetemperos	1
carolstoffella	carolstoffella	1
carla.candace	carla.candace	1
comidaselugaresemteresina	comidaselugaresemteresina	1
fabio_maluf_tognola	fabio_maluf_tognola	1
buzinaburgers	buzinaburgers	1
rannasburger	rannasburger	1
la_casa_do_bone_	la_casa_do_bone_	1
naocarestaurante	naocarestaurante	1
johnsburguer_	johnsburguer_	1
botecofaaca	botecofaaca	1
spoleto_oficial	spoleto_oficial	1
caldinhodonenen.oficial	caldinhodonenen.oficial	1
cozinhafit	cozinhafit	1
le_bife	le_bife	1
mestredochurrasco.com.br	mestredochurrasco.com.br	1
acougueamazonas	acougueamazonas	1
lumodaas	lumodaas	1
modernmammaosteria	modernmammaosteria	1
tatasushi	tatasushi	1
oquevamoscomer	oquevamoscomer	1
beefpassion	beefpassion	1
tvchurrasco	tvchurrasco	1
emagrecersemradicalismo	emagrecersemradicalismo	1
pontaodolagosul	pontaodolagosul	1
chefsclub	chefsclub	1
leticiarebuelta	leticiarebuelta	1
projetoquesefoda	projetoquesefoda	1
chefauricelioromao	chefauricelioromao	1
maisburguinho	maisburguinho	1
quirosgourmet	quirosgourmet	1
carneirodoordonesoriginal	carneirodoordonesoriginal	1
villefortatacarejo	villefortatacarejo	1
aquiemsantostem	aquiemsantostem	1
cozinhadehojejp	cozinhadehojejp	1
sapavegana	sapavegana	1
terrazzarooftop	terrazzarooftop	1
sisenorbrasil	sisenorbrasil	1
nossoconceito	nossoconceito	1
casadary	casadary	1
texaspicanharia	texaspicanharia	1
joaopizzaoficial	joaopizzaoficial	1
organomix	organomix	1
juniordurski	juniordurski	1
nataldicas	nataldicas	1
cozinhadara	cozinhadara	1
marinhoseafood	marinhoseafood	1
papinha_dobebe	papinha_dobebe	1
madecozinha	madecozinha	1
veganos_brasil	veganos_brasil	1
nalutapelopesoideal	nalutapelopesoideal	1
andrenutrichef	andrenutrichef	1
paocomcarne_hamburgueria	paocomcarne_hamburgueria	1
comunidadevegan	comunidadevegan	1
templodacarnemarcosbassi	templodacarnemarcosbassi	1
luciananunesnutri	luciananunesnutri	1
kellyamordiaadia	kellyamordiaadia	1
recepedia_br	recepedia_br	1
dalvaedito	dalvaedito	1
jazzrestaurante	jazzrestaurante	1
raizsorganicos	raizsorganicos	1
hamburgueriatradi	hamburgueriatradi	1
renato.abdalla	renato.abdalla	1
rafalasalvia	rafalasalvia	1
crocobeach	crocobeach	1
delucagastronomia	delucagastronomia	1
chefairfryer	chefairfryer	1
amazonassteakhouse	amazonassteakhouse	1
monalyzasouzachef	monalyzasouzachef	1
monteiroburguer	monteiroburguer	1
culinaria_veganas	culinaria_veganas	1
restaurantetopodomundo	restaurantetopodomundo	1
cheflucassantos	cheflucassantos	1
dicadejapas	dicadejapas	1
mchef_eduardor	mchef_eduardor	1
meatzburger	meatzburger	1
riofaciloficial	riofaciloficial	1
drdiogosimao	drdiogosimao	1
bullprimecarnes	bullprimecarnes	1
veganismo_simples	veganismo_simples	1
fogaodali	fogaodali	1
duplagourmet	duplagourmet	1
casabauducco	casabauducco	1
riopara2	riopara2	1
bazarhudson	bazarhudson	1
cheffranciscopinheiro	cheffranciscopinheiro	1
vigorbrasil	vigorbrasil	1
sergiopromoter	sergiopromoter	1
receitasvegetarianasfaceis	receitasvegetarianasfaceis	1
ruimorschel	ruimorschel	1
aboacarioca	aboacarioca	1
drericlara	drericlara	1
marcelofacini	marcelofacini	1
_lorenaabreu	_lorenaabreu	1
armazem7oficial	armazem7oficial	1
paraibacarnedesol	paraibacarnedesol	1
nacozinhadabruninha	nacozinhadabruninha	1
nandamuller	nandamuller	1
adietacetogenica	adietacetogenica	1
janainaendocrino	janainaendocrino	1
lowcarb.receitasaudavel	lowcarb.receitasaudavel	1
chefvandahering	chefvandahering	1
projeto.mulher.fitness	projeto.mulher.fitness	1
erica_cristina_basilio	erica_cristina_basilio	1
curtebh	curtebh	1
camaroesnatal	camaroesnatal	1
alokadofogao	alokadofogao	1
vejacomerebeber	vejacomerebeber	1
sergipeviagens	sergipeviagens	1
dietade18diasof	dietade18diasof	1
veguiaoficial	veguiaoficial	1
mchefvalter	mchefvalter	1
aprendaadieta	aprendaadieta	1
naurestaurante	naurestaurante	1
dimannooficial	dimannooficial	1
visioninfluencer	visioninfluencer	1
blackbeefbr	blackbeefbr	1
jamesdelivery	jamesdelivery	1
bessagrilljp	bessagrilljp	1
sazonbrasil	sazonbrasil	1
lowcarbemagrecafacil	lowcarbemagrecafacil	1
holyburgersp	holyburgersp	1
jeronimoburger	jeronimoburger	1
recifecomerbebercomprar	recifecomerbebercomprar	1
vargascutelaria	vargascutelaria	1
eduqueseupeso	eduqueseupeso	1
supermercadosmundial	supermercadosmundial	1
patriciocarvalho21	patriciocarvalho21	1
dicadepousadas	dicadepousadas	1
melhor_dieta_aqui	melhor_dieta_aqui	1
estejafit	estejafit	1
reidascarnes	reidascarnes	1
viagemegastronomia	viagemegastronomia	1
dicadehamburguer	dicadehamburguer	1
revistamenu	revistamenu	1
fitfood_ideas	fitfood_ideas	1
turistandosp	turistandosp	1
churrasco.nota10	churrasco.nota10	1
rafagomeschef	rafagomeschef	1
thaiscontenutri	thaiscontenutri	1
maisdicasfit	maisdicasfit	1
cantodomato	cantodomato	1
universo.saudavel	universo.saudavel	1
belezas.suburbio	belezas.suburbio	1
hoteisepousadasbahia	hoteisepousadasbahia	1
churrascoterapia	churrascoterapia	1
temperofiitness_	temperofiitness_	1
lojaswift	lojaswift	1
bardadonaonca	bardadonaonca	1
pe_de_sofa	pe_de_sofa	1
chefraissarr	chefraissarr	1
_alimentacaointeligente	_alimentacaointeligente	1
praiasdepernambuco	praiasdepernambuco	1
focoparaser.fitness	focoparaser.fitness	1
michellegherardi	michellegherardi	1
cozinhachic	cozinhachic	1
importadosbr	importadosbr	1
renanmultimarcas3	renanmultimarcas3	1
veganapratica	veganapratica	1
saborcaseirodapri	saborcaseirodapri	1
aleluglio	aleluglio	1
veronicalaino	veronicalaino	1
ondecomernorio	ondecomernorio	1
kfcbrasil	kfcbrasil	1
aquisaudavel	aquisaudavel	1
lowcarb.comsabrina	lowcarb.comsabrina	1
bookdereceitas	bookdereceitas	1
sampadicas	sampadicas	1
vassouraquebrada	vassouraquebrada	1
programaeduguedesevoce	programaeduguedesevoce	1
guiadohamburguer	guiadohamburguer	1
clubedapicanhatrend	clubedapicanhatrend	1
pizzahutbrasil	pizzahutbrasil	1
lojamariagueixa	lojamariagueixa	1
lowcarb.comrose	lowcarb.comrose	1
andrepionteke	andrepionteke	1
dicas_de_alimentacao_saudavel_	dicas_de_alimentacao_saudavel_	1
gaspaindica	gaspaindica	1
ebassoleil	ebassoleil	1
paulinhaboque	paulinhaboque	1
guialowcarb	guialowcarb	1
lowcarb_pratico	lowcarb_pratico	1
prontolight	prontolight	1
pratinhodobebe	pratinhodobebe	1
barbecueking	barbecueking	1
vilagale	vilagale	1
bebebomdegarfo	bebebomdegarfo	1
afonsakelly	afonsakelly	1
fabirribeiro	fabirribeiro	1
rickbolzani	rickbolzani	1
ekiprozetaoficial	ekiprozetaoficial	1
receitasfitblog	receitasfitblog	1
segundasemcarne	segundasemcarne	1
emagrecacomsaude76	emagrecacomsaude76	1
joicesaraiva	joicesaraiva	1
secafranoficial	secafranoficial	1
clubedochurrasqueirooficial	clubedochurrasqueirooficial	1
raul_lemos	raul_lemos	1
dicas_de_emagrecimento.oficial	dicas_de_emagrecimento.oficial	1
cura.espiritual	cura.espiritual	1
lowcarb_receitasfit	lowcarb_receitasfit	1
cozinhasdesucesso	cozinhasdesucesso	1
hojetemjp	hojetemjp	1
churrasco.perfeito	churrasco.perfeito	1
receitas.fitness_	receitas.fitness_	1
amochurrascooficial	amochurrascooficial	1
gastronomia.viagens	gastronomia.viagens	1
clubedoavental	clubedoavental	1
emagrecabem16	emagrecabem16	1
gulacerta	gulacerta	1
receitas.fiitness_	receitas.fiitness_	1
lowcarbreceitasfaceiss	lowcarbreceitasfaceiss	1
kitchenaidbrasil	kitchenaidbrasil	1
ubereats_br	ubereats_br	1
nutricionistapatricialeite	nutricionistapatricialeite	1
tiajonacozinha	tiajonacozinha	1
comidasdefitness	comidasdefitness	1
drafernandasilvapaleo	drafernandasilvapaleo	1
santafeacostela	santafeacostela	1
receitasfitefat	receitasfitefat	1
hugomerchan	hugomerchan	1
churrasco_dicas_e_receitas	churrasco_dicas_e_receitas	1
motivar_a_emagrecer	motivar_a_emagrecer	1
sociedadevegetariana	sociedadevegetariana	1
dieta.lowcarb.fit	dieta.lowcarb.fit	1
fasano	fasano	1
lowcarb_alimentacao	lowcarb_alimentacao	1
emagrecerdevezoficial	emagrecerdevezoficial	1
thaismassa	thaismassa	1
receitaslowcarbsfit	receitaslowcarbsfit	1
cozi_bag	cozi_bag	1
canaldoscacadores	canaldoscacadores	1
mohindi	mohindi	1
wagyu_beef	wagyu_beef	1
receita.lowcarrb	receita.lowcarrb	1
dicadehoteis	dicadehoteis	1
gramadoblog	gramadoblog	1
fitcomlowcarb	fitcomlowcarb	1
blognoticiatv	blognoticiatv	1
leonardopaixao	leonardopaixao	1
receitas_veganas_simples_	receitas_veganas_simples_	1
salgastronomia	salgastronomia	1
sigareceitas_saudaveis	sigareceitas_saudaveis	1
bem_estaresaude	bem_estaresaude	1
chefekadubarros	chefekadubarros	1
c_troisgros	c_troisgros	1
hugoribeir0	hugoribeir0	1
ifoodbrasil	ifoodbrasil	1
light_detox	light_detox	1
receitasdicasfit	receitasdicasfit	1
dicasdekaza	dicasdekaza	2
diywhirl	diywhirl	2
magic9y	magic9y	2
sayloveit	sayloveit	2
roseoliveira_tartes	roseoliveira_tartes	2
diyartesanatomania	diyartesanatomania	2
lardafafa	lardafafa	2
casaadorno	casaadorno	2
costura_brasil	costura_brasil	2
ecoartedecoraca	ecoartedecoraca	2
meular.com.amor	meular.com.amor	2
bya_jcferreira	bya_jcferreira	2
micheletrevisanorganiza	micheletrevisanorganiza	2
lenara.artes	lenara.artes	2
recicleartesanato	recicleartesanato	2
arteemevatatianecampos	arteemevatatianecampos	2
palletmaniaoficial	palletmaniaoficial	2
painelexpresso	painelexpresso	2
organizaessabagunca	organizaessabagunca	2
diycomfabiananogueira	diycomfabiananogueira	2
meiredona	meiredona	2
merapi.oficial	merapi.oficial	2
abrilhantandosuafesta	abrilhantandosuafesta	2
lardecor_dadeh	lardecor_dadeh	2
cantinho_da_raquel	cantinho_da_raquel	2
ideralvesoficial	ideralvesoficial	2
dicasparafestasoficial	dicasparafestasoficial	2
armazem_urbano	armazem_urbano	2
mimosdadeise_1314	mimosdadeise_1314	2
compartilhandoarte	compartilhandoarte	2
showdeartesanato	showdeartesanato	2
inspiraredecoracoes	inspiraredecoracoes	2
pedagogiando_por_ai	pedagogiando_por_ai	2
parececomprado	parececomprado	2
bubadiy	bubadiy	2
santafefeltros	santafefeltros	2
c.rosada	c.rosada	2
decoracaogeralparafesta	decoracaogeralparafesta	2
doce.lar.da.deb	doce.lar.da.deb	2
dressacarolinne	dressacarolinne	2
blogmontandominhafesta	blogmontandominhafesta	2
artesanatomariafigueiredo	artesanatomariafigueiredo	2
metdaan.diy	metdaan.diy	2
lacinhoslucrativos	lacinhoslucrativos	2
receitasaprenda	receitasaprenda	2
artesanatonew	artesanatonew	2
10ideass	10ideass	2
diydecorr	diydecorr	2
artes.e.decor	artes.e.decor	2
chocolateparadise	chocolateparadise	2
claudia.dudus	claudia.dudus	2
tutorialdegirl	tutorialdegirl	2
desserts.10	desserts.10	2
artecomcapricho	artecomcapricho	2
artesanatodecora	artesanatodecora	2
palet_decor_	palet_decor_	2
decorarte_decoracao	decorarte_decoracao	2
valdireneoliveiradiy	valdireneoliveiradiy	2
vemaprenderfazer	vemaprenderfazer	2
meu.lar.minhapaz	meu.lar.minhapaz	2
meudecorar	meudecorar	2
janeteferreiragyn	janeteferreiragyn	2
oficial_casadecorada	oficial_casadecorada	2
gavetamix	gavetamix	2
revistaartesanato	revistaartesanato	2
artesanatolove	artesanatolove	2
diylyric	diylyric	2
clubedoartesanatooficial	clubedoartesanatooficial	2
costurabelaarte	costurabelaarte	2
maniadedecoracao	maniadedecoracao	2
globalcreatived	globalcreatived	2
entrenafesta	entrenafesta	2
vibetutoriais	vibetutoriais	2
artesanatodecorjardim	artesanatodecorjardim	2
mania.de.decorar	mania.de.decorar	2
cantinho.do.artesanato.br	cantinho.do.artesanato.br	2
mari_docedelar	mari_docedelar	2
diycomvivi	diycomvivi	2
diycore	diycore	2
hacksclips	hacksclips	2
mostrandocomosefaz	mostrandocomosefaz	2
amelia.requintada	amelia.requintada	2
lucrandocomartesanatos	lucrandocomartesanatos	2
foodytap	foodytap	2
tudogostosooficial	tudogostosooficial	2
diyfty	diyfty	2
namorando.arte	namorando.arte	2
dream.foody	dream.foody	2
pequena_casa08	pequena_casa08	2
diyclap	diyclap	2
games.da.depressao	games.da.depressao	3
nacaodosgamers	nacaodosgamers	3
leitaogamer	leitaogamer	3
manualdosgames_	manualdosgames_	3
gamerbrasil_	gamerbrasil_	3
gamcomoficial	gamcomoficial	3
eigames	eigames	3
jlnicastro.game	jlnicastro.game	3
fortnite.brasil	fortnite.brasil	3
freefire_brasil_ofi	freefire_brasil_ofi	3
lendasfreefire_	lendasfreefire_	3
freefirebr_ff	freefirebr_ff	3
freefiremania.com.br	freefiremania.com.br	3
freefirebrasl	freefirebrasl	3
freefirereal__	freefirereal__	3
freefirememes._	freefirememes._	3
freefire.memesbr	freefire.memesbr	3
gamermemesbr	gamermemesbr	3
freefirebrasil_news	freefirebrasil_news	3
freefirermemes	freefirermemes	3
freefiire_memes	freefiire_memes	3
freefire.memes2	freefire.memes2	3
freefirebrmemesll	freefirebrmemesll	3
fortnite.br	fortnite.br	3
fortnaticos.oficial	fortnaticos.oficial	3
fortmeme	fortmeme	3
fortnitebrfeed	fortnitebrfeed	3
forrtnite	forrtnite	3
fortnitebalance	fortnitebalance	3
minecraft.br	minecraft.br	3
minecraftdadepressao	minecraftdadepressao	3
karlluseduardoyt	karlluseduardoyt	3
freefire_e_vida	freefire_e_vida	3
megafreefire_	megafreefire_	3
fazopofc_	fazopofc_	3
losgrandesfreefire	losgrandesfreefire	3
metasfreefire	metasfreefire	3
freeffirebrasil	freeffirebrasil	3
depauloxfire	depauloxfire	3
minecraftbestofbuilds	minecraftbestofbuilds	3
gamerzonebrasil	gamerzonebrasil	3
forthnite	forthnite	3
thebattlepass	thebattlepass	3
bestminecraftdesigns	bestminecraftdesigns	3
bronziocre	bronziocre	3
b4ofc	b4ofc	3
godesportsoficial	godesportsoficial	3
ligadolol_	ligadolol_	3
x1_yasuo	x1_yasuo	3
fortnitebrasilgame	fortnitebrasilgame	3
marveldadepressao	marveldadepressao	3
casal_free_fire_oficial	casal_free_fire_oficial	3
poeta_tv	poeta_tv	3
keve.ff	keve.ff	3
sombra.hzs	sombra.hzs	3
blackn444ofc	blackn444ofc	3
negaf.f	negaf.f	3
dinozoeiro	dinozoeiro	3
_megafreefire	_megafreefire	3
dacruzff	dacruzff	3
ff_daiane	ff_daiane	3
farpador_ofc	farpador_ofc	3
dantes.ff	dantes.ff	3
freefire.br_brasil	freefire.br_brasil	3
ygorx_ff	ygorx_ff	3
rafis.sx	rafis.sx	3
guitex.ff	guitex.ff	3
hyperxff	hyperxff	3
apelaxablau.sx	apelaxablau.sx	3
juniin.ip	juniin.ip	3
tanpz.ff	tanpz.ff	3
dataxr	dataxr	3
souzazz_	souzazz_	3
freefireclipadaas	freefireclipadaas	3
revelandoproplayer_ff	revelandoproplayer_ff	3
lol_memes_oficial	lol_memes_oficial	3
bronzeocrime	bronzeocrime	3
reizin_clipss	reizin_clipss	3
nobrutv	nobrutv	3
loud_babi	loud_babi	3
mcpozedorodo	mcpozedorodo	3
loudgg	loudgg	3
levelup_007	levelup_007	3
othiagoventura	othiagoventura	3
minecraft	minecraft	3
crusherfooxi10	crusherfooxi10	3
cerolzera	cerolzera	3
mcmaellenn	mcmaellenn	3
apelapato	apelapato	3
two9_ff	two9_ff	3
hudsonamorim1	hudsonamorim1	3
mongraal	mongraal	3
ellton777	ellton777	3
gb0012	gb0012	3
deusogrego	deusogrego	3
leagueoflegends	leagueoflegends	3
loud_thaiga	loud_thaiga	3
fixa.10	fixa.10	3
since_ff	since_ff	3
loud.will	loud.will	3
piuzinholl	piuzinholl	3
maari.tavares	maari.tavares	3
fecastanhari	fecastanhari	3
loud_jordanxp	loud_jordanxp	3
tsm_myth	tsm_myth	3
fred	fred	3
benjyfishy	benjyfishy	3
nyviestephan	nyviestephan	3
freefirebr_oficial	freefirebr_oficial	3
fiexx_ff	fiexx_ff	3
vraunelasz	vraunelasz	3
lucasinutilismo	lucasinutilismo	3
mrfreshasian	mrfreshasian	3
esporteinterativo	esporteinterativo	3
escoladadepressao	escoladadepressao	3
southamericamemes	southamericamemes	3
jogador245	jogador245	3
ghost9.rs	ghost9.rs	3
fazeh1ghsky1	fazeh1ghsky1	3
cellbitos	cellbitos	3
shottz_ff	shottz_ff	3
calaaaango	calaaaango	3
leonardosteluto	leonardosteluto	3
coreano0_tv	coreano0_tv	3
ale.maze	ale.maze	3
ubita69	ubita69	3
antronixxgyt	antronixxgyt	3
corinthians.ff	corinthians.ff	3
dedeof	dedeof	3
riquelme.fut	riquelme.fut	3
eagletrindade	eagletrindade	3
buxexatv	buxexatv	3
rekkon_ff	rekkon_ff	3
ousadoj	ousadoj	3
wh1skyj	wh1skyj	3
1zezao	1zezao	3
barbiezinhaxts	barbiezinhaxts	3
loserfruit	loserfruit	3
saporramito	saporramito	3
natividadeff	natividadeff	3
prozingamer	prozingamer	3
nickeh30	nickeh30	3
brttoficial	brttoficial	3
vgzinnn	vgzinnn	3
gabrielneox	gabrielneox	3
sypherpk	sypherpk	3
brunoplayhard	brunoplayhard	3
flakespower	flakespower	3
ss_taami	ss_taami	3
el_guhplays	el_guhplays	3
cajucapitani	cajucapitani	3
loud_bak	loud_bak	3
rachaxp	rachaxp	3
build.ig	build.ig	3
copanobru	copanobru	3
minecraft_reddit	minecraft_reddit	3
arecs.ff	arecs.ff	3
bcctrolling	bcctrolling	3
flowpdc	flowpdc	3
petjordan	petjordan	3
vege.ff	vege.ff	3
razure_ff	razure_ff	3
el_dizkil	el_dizkil	3
jogaeasyfreefire	jogaeasyfreefire	3
einerd.com.br	einerd.com.br	3
dianazambrozuski	dianazambrozuski	3
raelzn.sx	raelzn.sx	3
thgnoe	thgnoe	3
maumauzk	maumauzk	3
bdl_glz	bdl_glz	3
joaocaetano	joaocaetano	3
yuuriff_	yuuriff_	3
illegalminecraft	illegalminecraft	3
memesbrr1	memesbrr1	3
nobrutv.4	nobrutv.4	3
napponxl	napponxl	3
ggeasy_66	ggeasy_66	3
victorando	victorando	3
nilmoretto	nilmoretto	3
isaffonti	isaffonti	3
marvelbrasil	marvelbrasil	3
astrox.ofc	astrox.ofc	3
gaules	gaules	3
edson.god	edson.god	3
luanclashwar	luanclashwar	3
desimpedidos	desimpedidos	3
ronalld77	ronalld77	3
gizao_rs	gizao_rs	3
vrziin33	vrziin33	3
rafax_ff	rafax_ff	3
fc_piuzinhoff	fc_piuzinhoff	3
cebolinhaff_	cebolinhaff_	3
se7enofc	se7enofc	3
cherry_rar	cherry_rar	3
ascronicasdewesley	ascronicasdewesley	3
moreno9.ff	moreno9.ff	3
vocesabiavideo	vocesabiavideo	3
wizeff_	wizeff_	3
stonedyoda	stonedyoda	3
gideemsd	gideemsd	3
sheviii2k	sheviii2k	3
tropa.lucca	tropa.lucca	3
fasmarvelbrasil	fasmarvelbrasil	3
adorocinema	adorocinema	3
intzanarchysons	intzanarchysons	3
decotv_	decotv_	3
carolmillicent	carolmillicent	3
minecraftbuildsdesigns	minecraftbuildsdesigns	3
painkami	painkami	3
brksedu	brksedu	3
playstation_br	playstation_br	3
theussxd	theussxd	3
fortnitemem007	fortnitemem007	3
whiteffofc	whiteffofc	3
vnzinnn	vnzinnn	3
modestiatv	modestiatv	3
loudggdadepressao	loudggdadepressao	3
vanquilha	vanquilha	3
kauelok	kauelok	3
theuz_alvez	theuz_alvez	3
tropa.gg	tropa.gg	3
frescodft	frescodft	3
scoped	scoped	3
fatosdesconhecidos	fatosdesconhecidos	3
surtada_freefire	surtada_freefire	3
baconofminecraft	baconofminecraft	3
luizhfontes	luizhfontes	3
duduffx	duduffx	3
patrickblackoutz	patrickblackoutz	3
forsaken.ofc	forsaken.ofc	3
ilha_dos_memes	ilha_dos_memes	3
liga.nfa	liga.nfa	3
guilda_kof	guilda_kof	3
minecraft.porkchop	minecraft.porkchop	3
minecraft_mp4	minecraft_mp4	3
rustyofc	rustyofc	3
igorilatv	igorilatv	3
leagueoflegendsbrasil	leagueoflegendsbrasil	3
parrot.mp4	parrot.mp4	3
crafting.bench	crafting.bench	3
cyrix.tl	cyrix.tl	3
epicgames	epicgames	3
suesa_s	suesa_s	3
umadanii	umadanii	3
minecraftforbidden	minecraftforbidden	3
demon.ffx	demon.ffx	3
memesminecraft_	memesminecraft_	3
lixeiramemes	lixeiramemes	3
samemes.com.br	samemes.com.br	3
wendel_bezerra	wendel_bezerra	3
panagcraft	panagcraft	3
minecraftbuilds.daily	minecraftbuilds.daily	3
superxandao	superxandao	3
tuegay_mano	tuegay_mano	3
yanxntj	yanxntj	3
nauakff_	nauakff_	3
disruptive_builds	disruptive_builds	3
thomefn	thomefn	3
coronel.ofc	coronel.ofc	3
omelete	omelete	3
forevitao	forevitao	3
kratos027	kratos027	3
ssofc_	ssofc_	3
sona.nt	sona.nt	3
yasuozn	yasuozn	3
tfue.insta	tfue.insta	3
ff_braga7	ff_braga7	3
shotgunx.ff	shotgunx.ff	3
ivoedits	ivoedits	3
loud_kronos	loud_kronos	3
caioxrocha	caioxrocha	3
ocastrin	ocastrin	3
minecraftbuildinggod	minecraftbuildinggod	3
greghiff	greghiff	3
brooocraft	brooocraft	3
xandyff_	xandyff_	3
gmxx_ff	gmxx_ff	3
nicolediretora	nicolediretora	3
freefirebrasil.ff	freefirebrasil.ff	3
shazanbruttotv	shazanbruttotv	3
haru_jiggly	haru_jiggly	3
cauanff_	cauanff_	3
caponezin	caponezin	3
fazinzz	fazinzz	3
crow.ff	crow.ff	3
cliipadasffx	cliipadasffx	3
proboot444	proboot444	3
esportsfreefire	esportsfreefire	3
glxckzin	glxckzin	3
voice_makers	voice_makers	3
xexeuff	xexeuff	3
drear__builds	drear__builds	3
texas.sx	texas.sx	3
pubertyhumor	pubertyhumor	3
fortnite7am	fortnite7am	3
jasmineff__	jasmineff__	3
fexerff	fexerff	3
paingamingbr	paingamingbr	3
mcraftguide	mcraftguide	3
freefirebrasil__	freefirebrasil__	3
_bigpog	_bigpog	3
rubronegro.ff	rubronegro.ff	3
luiznxff	luiznxff	3
ydiamondd	ydiamondd	3
camila_falk	camila_falk	3
nicksfps	nicksfps	3
dionesfer	dionesfer	3
theradioativo	theradioativo	3
aranhahue	aranhahue	3
flaesports	flaesports	3
ur.underrated	ur.underrated	3
debstlemos	debstlemos	3
freefire_momentos	freefire_momentos	3
dc.da.depressao	dc.da.depressao	3
jogasamuca	jogasamuca	3
legiaodosherois	legiaodosherois	3
netos7_	netos7_	3
drxkonz	drxkonz	3
daily_minecraft_tips	daily_minecraft_tips	3
wndelff	wndelff	3
freefirenoha	freefirenoha	3
r4fa.ff	r4fa.ff	3
alokgamechanger	alokgamechanger	3
xabrau.op	xabrau.op	3
vivokeyd	vivokeyd	3
nieel_015	nieel_015	3
l4kill_ff	l4kill_ff	3
spitflow	spitflow	3
reinadodosnerds	reinadodosnerds	3
bryan_mojak	bryan_mojak	3
minecraftkool	minecraftkool	3
fortnltevldeos	fortnltevldeos	3
ss_ostnj	ss_ostnj	3
fcnobru.tv	fcnobru.tv	3
dzn420	dzn420	3
thaleshenriquecg	thaleshenriquecg	3
fatosnerdoficial	fatosnerdoficial	3
fortnite.br.oficial	fortnite.br.oficial	3
freefirebr.ff	freefirebr.ff	3
freefirezueira	freefirezueira	3
revoltznj	revoltznj	3
instaplayersff	instaplayersff	3
itsfilipefn	itsfilipefn	3
k1nzellfn	k1nzellfn	3
brunaoftn	brunaoftn	3
viciadosporfilmes	viciadosporfilmes	3
renanzo	renanzo	3
itemshoproyale	itemshoproyale	3
trickztaryt	trickztaryt	3
bakzinpride	bakzinpride	3
sharshock	sharshock	3
apelapato_fc_oficial	apelapato_fc_oficial	3
fortnitesets	fortnitesets	3
fc_elgato1	fc_elgato1	3
booyahbr	booyahbr	3
theuuzinrj	theuuzinrj	3
jaozin.sx	jaozin.sx	3
odsbronze	odsbronze	3
baianolol	baianolol	3
minecraft.latest	minecraft.latest	3
flesf.f	flesf.f	3
free_firebrasil	free_firebrasil	3
odavyjones	odavyjones	3
wilkashi	wilkashi	3
_yoshizinn	_yoshizinn	3
mafiosa__ff	mafiosa__ff	3
nobru.tv	nobru.tv	3
meme.fino	meme.fino	3
loud_24horas	loud_24horas	3
legadodamarvel	legadodamarvel	3
cellinrj	cellinrj	3
wwwingrids	wwwingrids	3
metaslosgrandes2.0	metaslosgrandes2.0	3
paitambemjoga	paitambemjoga	3
marveltrechos	marveltrechos	3
freefireclipadass	freefireclipadass	3
reinonerdgeek	reinonerdgeek	3
freefirememesj	freefirememesj	3
minecraftbuildstutorial	minecraftbuildstutorial	3
rg4_frank	rg4_frank	3
andreozin_tv	andreozin_tv	3
zenon.gp	zenon.gp	3
minecraftconstantly	minecraftconstantly	3
xboxbr	xboxbr	3
sargento_ofc	sargento_ofc	3
kyurenii	kyurenii	3
nandabellissimo	nandabellissimo	3
ubisoftbrasil	ubisoftbrasil	3
_ffdestroy	_ffdestroy	3
garena_fli_flai	garena_fli_flai	3
minecraft.perspective.yt	minecraft.perspective.yt	3
gameoveroficial_	gameoveroficial_	3
gordox	gordox	3
minecraftinspirational	minecraftinspirational	3
nimotv_brasil	nimotv_brasil	3
liviax7_	liviax7_	3
riyuuka	riyuuka	3
pmgamingoficial	pmgamingoficial	3
karenml_ff	karenml_ff	3
legendlovefr	legendlovefr	3
fortnite.game	fortnite.game	3
steve_sincero_kkkk	steve_sincero_kkkk	3
cartoonnetworkbrasil	cartoonnetworkbrasil	3
codigos.freefire	codigos.freefire	3
liga.lbr	liga.lbr	3
geekdoinfinito	geekdoinfinito	3
host2k.ff	host2k.ff	3
forrtnte	forrtnte	3
walkergaymer	walkergaymer	3
freefirebestnews_br	freefirebestnews_br	3
mund2freefire	mund2freefire	3
freefirebrrasil	freefirebrrasil	3
mylonzete	mylonzete	3
cavernadoheroi	cavernadoheroi	3
marcelo_ff2.0	marcelo_ff2.0	3
fortnitesections	fortnitesections	3
therealempiire	therealempiire	3
noe_oficiall	noe_oficiall	3
fbr.ig	fbr.ig	3
fleivinha	fleivinha	3
fortnitebr	fortnitebr	3
najeeslays	najeeslays	3
gnanews	gnanews	3
galaxiadosnerds	galaxiadosnerds	3
momos_fri_fair_4k	momos_fri_fair_4k	3
bebecitaa_ff	bebecitaa_ff	3
riveira_yt	riveira_yt	3
lolesportsbr	lolesportsbr	3
saporraguerra	saporraguerra	3
capone_tv	capone_tv	3
raafa_ff	raafa_ff	3
farpas_ofcl	farpas_ofcl	3
teamvikings	teamvikings	3
fbrsquad	fbrsquad	3
diabla666_ff	diabla666_ff	3
freefirecomunidade_	freefirecomunidade_	3
morfeo_ofc	morfeo_ofc	3
goatofminecraft	goatofminecraft	3
garenabrasil.oficial	garenabrasil.oficial	3
_fortflix	_fortflix	3
bart.ff	bart.ff	3
wildriftbr	wildriftbr	3
freefiregarenal	freefiregarenal	3
saporra_milgrau	saporra_milgrau	3
nathye	nathye	3
teamcomics	teamcomics	3
nojima.god	nojima.god	3
bueroficial	bueroficial	3
mario_santos08	mario_santos08	3
nobrutrv_	nobrutrv_	3
vkgames_oficial	vkgames_oficial	3
ffnegoney	ffnegoney	3
freefirebrasil.official	freefirebrasil.official	3
manolinhogeek	manolinhogeek	3
freefirehumorbr	freefirehumorbr	3
loudfc	loudfc	3
norcalballerss	norcalballerss	3
freefire.memes.argentina	freefire.memes.argentina	3
ff_fannytv	ff_fannytv	3
fortnitebrquiz	fortnitebrquiz	3
maisesportsbr	maisesportsbr	3
freefirememes.yt	freefirememes.yt	3
daniels.lol	daniels.lol	3
passedebatalha	passedebatalha	3
free_fire_memes_clipa	free_fire_memes_clipa	3
loud_memess	loud_memess	3
frasesdelol	frasesdelol	3
amandaaff2	amandaaff2	3
sofia.ffire	sofia.ffire	3
childhood.memorles	childhood.memorles	3
bruno_alvess77	bruno_alvess77	3
juanzin01_	juanzin01_	3
lost.noe	lost.noe	3
pipocando.oficial	pipocando.oficial	3
fortnitc	fortnitc	3
perdidof.f	perdidof.f	3
booyahlatam	booyahlatam	3
hp_anonymous	hp_anonymous	3
ovotzfn	ovotzfn	3
cuentasff.ha	cuentasff.ha	3
forrtleaks	forrtleaks	3
clipei_capa	clipei_capa	3
gta.vlds	gta.vlds	3
fortniteitemshop	fortniteitemshop	3
ff_josy777	ff_josy777	3
darkmelocoton	darkmelocoton	3
toxicitytxt	toxicitytxt	3
freefire_mundo_top	freefire_mundo_top	3
badmonkeys_sports	badmonkeys_sports	3
steve_sumiu_kkkkk	steve_sumiu_kkkkk	3
freefirezueira.brr	freefirezueira.brr	3
jhon.clipsff	jhon.clipsff	3
codiguin24horasfreefire	codiguin24horasfreefire	3
cerolclips_	cerolclips_	3
valorantbrasil	valorantbrasil	3
presepadageek	presepadageek	3
ze_terror_	ze_terror_	3
bestofminecraftbuilds	bestofminecraftbuilds	3
biggumsfn	biggumsfn	3
bnddobronzinho	bnddobronzinho	3
gaming._____.memes	gaming._____.memes	3
freefirebr_.ff	freefirebr_.ff	3
subadeelo	subadeelo	3
karolx_souza	karolx_souza	3
fortnitecapture	fortnitecapture	3
nosensemine_	nosensemine_	3
fflucas.tv	fflucas.tv	3
interfortnite	interfortnite	3
fortnlte.moments	fortnlte.moments	3
cerolzera.fc	cerolzera.fc	3
slixpods	slixpods	3
fortnitenovas	fortnitenovas	3
leaguedadepressao	leaguedadepressao	3
kidplayerr	kidplayerr	3
anjo_br_	anjo_br_	3
ff_atena77	ff_atena77	3
freefirecamp__	freefirecamp__	3
rankplug	rankplug	3
chartplug	chartplug	3
free_fire_momazo	free_fire_momazo	3
mahteiga	mahteiga	3
tschaeppi	tschaeppi	3
freefirediversao_	freefirediversao_	3
guilda_pisycos	guilda_pisycos	3
ff.savageofc	ff.savageofc	3
fortnitesig	fortnitesig	3
kakashiff.tv	kakashiff.tv	3
freefiremassacre	freefiremassacre	3
nobruutv.fc	nobruutv.fc	3
oxentefreefire	oxentefreefire	3
foxzada1	foxzada1	3
medofire_	medofire_	3
fortniteduo	fortniteduo	3
freeffirebr_	freeffirebr_	3
freefireclipadas1	freefireclipadas1	3
hypandoclips	hypandoclips	3
ff_poeta_fit	ff_poeta_fit	3
garenabrasil	garenabrasil	3
minecraftforest	minecraftforest	3
tm_elias_ff	tm_elias_ff	3
fortnlte.nostalgia	fortnlte.nostalgia	3
mn_tuegay2	mn_tuegay2	3
geekkingbrasil	geekkingbrasil	3
shisley15	shisley15	3
marveldadepressao2.0	marveldadepressao2.0	3
loudohana	loudohana	3
freefirecsmemes	freefirecsmemes	3
henry_souza.ofc	henry_souza.ofc	3
roubardo_	roubardo_	3
babictor_forev3r	babictor_forev3r	3
x.seyloon	x.seyloon	3
sorteiosmdd	sorteiosmdd	3
cami_ff.07	cami_ff.07	3
knerd.of	knerd.of	3
formulahighelo	formulahighelo	3
crazzyzao	crazzyzao	3
freefirememes277	freefirememes277	3
viih_massaki	viih_massaki	3
frefirebr_ff	frefirebr_ff	3
imagens_proibidas	imagens_proibidas	3
gaminggeekz	gaminggeekz	3
rapa_tv	rapa_tv	3
elggaming	elggaming	3
memes_locais	memes_locais	3
imperiomarvelbr	imperiomarvelbr	3
gamingdrugs	gamingdrugs	3
lendasfreefire_2	lendasfreefire_2	3
meninasjogandofreefire	meninasjogandofreefire	3
batista.tv	batista.tv	3
ghostjusiel	ghostjusiel	3
pbebrasil	pbebrasil	3
forevitaoo	forevitaoo	3
fortnitesources	fortnitesources	3
freefireargento1	freefireargento1	3
yo_soybunny	yo_soybunny	3
lastimarvel	lastimarvel	3
ff_arcanjo2	ff_arcanjo2	3
fortbubble	fortbubble	3
rocketleague.brasil	rocketleague.brasil	3
sociedadegeek	sociedadegeek	3
x1y0ne	x1y0ne	3
yt_virti	yt_virti	3
danyjrgamer	danyjrgamer	3
jv_castrequini	jv_castrequini	3
gamingworld.tv	gamingworld.tv	3
su4skin	su4skin	3
canal_os_parcas	canal_os_parcas	3
depauloxfire2	depauloxfire2	3
oeditors_	oeditors_	3
sebastianchelminski	sebastianchelminski	3
awesomebuild	awesomebuild	3
cnbesc	cnbesc	3
runeterrabrasil	runeterrabrasil	3
savethenexus	savethenexus	3
postdealar	postdealar	3
thepiero.ff	thepiero.ff	3
razerbrasil	razerbrasil	3
patron2.ff	patron2.ff	3
teamfighttacticsbrasil	teamfighttacticsbrasil	3
gamenota10	gamenota10	3
fortniteleaker05	fortniteleaker05	3
docinho.nobru	docinho.nobru	3
academiadosgamersoficial	academiadosgamersoficial	3
prota_games	prota_games	3
barbiiashe	barbiiashe	3
free_luciano	free_luciano	3
rainha_rica	rainha_rica	3
bdmesport	bdmesport	3
dmf.yt_	dmf.yt_	3
akemytv	akemytv	3
gs_vendasff	gs_vendasff	3
memes_games01	memes_games01	3
alexismilko	alexismilko	3
itskaluu	itskaluu	3
saleskills10	saleskills10	3
v7games_br	v7games_br	3
freefire.rifas	freefire.rifas	3
speeddriftersbr	speeddriftersbr	3
mau.ff	mau.ff	3
peixoto_surfista	peixoto_surfista	3
_piuff	_piuff	3
galaxiadeherois	galaxiadeherois	3
tropafortnite34k.oficial	tropafortnite34k.oficial	3
xdarkevilofficial	xdarkevilofficial	3
luh_atizorio	luh_atizorio	3
fecosplay	fecosplay	3
craftbenchmc	craftbenchmc	3
equipekillofc	equipekillofc	3
badboyff.ofc	badboyff.ofc	3
gabe041.ff	gabe041.ff	3
jhowgameroficial	jhowgameroficial	3
ajota_youtube	ajota_youtube	3
zedfortnite	zedfortnite	3
nerdsdagalaxia	nerdsdagalaxia	3
eusupernerd	eusupernerd	3
minecraftcitygod	minecraftcitygod	3
ludinhoff	ludinhoff	3
akalitv	akalitv	3
infinitynewsbr	infinitynewsbr	3
vendasptg	vendasptg	3
minecraftassembling	minecraftassembling	3
stylizedresourcepack	stylizedresourcepack	3
minecraftbuilds.gali	minecraftbuilds.gali	3
lolsorteiosbr	lolsorteiosbr	3
sorteiosgarenaff	sorteiosgarenaff	3
allbankesports	allbankesports	3
agora_ta_mec	agora_ta_mec	3
antoniogirardi_	antoniogirardi_	3
bumify	bumify	3
bumjerky	bumjerky	3
coguvaca_morreu_kkkkk	coguvaca_morreu_kkkkk	3
crema_builds	crema_builds	3
dailyminecraftleaks	dailyminecraftleaks	3
entertalning	entertalning	3
expliictt	expliictt	3
fmlpranks	fmlpranks	3
gamingmeme_s	gamingmeme_s	3
juhevans	juhevans	3
laughplugs	laughplugs	3
lolgirlsbr	lolgirlsbr	3
loud.baabi	loud.baabi	3
loud_miihx	loud_miihx	3
loud_thurzinx	loud_thurzinx	3
mc.buildingprojects	mc.buildingprojects	3
mechzada	mechzada	3
memeseprintsvirais	memeseprintsvirais	3
memesroutines	memesroutines	3
mincraftfunny	mincraftfunny	3
steve_morreu_kkkkk	steve_morreu_kkkkk	3
upgradememez	upgradememez	3
minecraft.architects	minecraft.architects	3
resistenciadc	resistenciadc	3
barrosofarm	barrosofarm	3
f1analista	f1analista	3
waspycraft	waspycraft	3
detetive_da_explicacaoo	detetive_da_explicacaoo	3
keiozinn	keiozinn	3
napp_lab	napp_lab	3
myminecraftbase	myminecraftbase	3
mcbannerss	mcbannerss	3
louud_bak.fc	louud_bak.fc	3
thebenchhub	thebenchhub	3
clebitoyt	clebitoyt	3
executivetree	executivetree	3
ayel.lol	ayel.lol	3
justtryofc	justtryofc	3
mau.news	mau.news	3
loud_thurziinm	loud_thurziinm	3
esacarry	esacarry	3
daryki	daryki	3
robolol1	robolol1	3
instamallufollowers	instamallufollowers	3
squallzera	squallzera	3
animes.da.depressao	animes.da.depressao	3
loud.voltann	loud.voltann	3
meikodboy_	meikodboy_	3
lusantana_arts	lusantana_arts	3
fortnitefarmer1	fortnitefarmer1	3
minecrraft_memes	minecrraft_memes	3
gabs_am	gabs_am	3
sorteiosgratis.ff	sorteiosgratis.ff	3
nerdifique_se	nerdifique_se	3
barbosa_phl	barbosa_phl	3
freefirepremiosbr	freefirepremiosbr	3
mine_craftmc	mine_craftmc	3
ff.codiguingratis_	ff.codiguingratis_	3
revoltalol	revoltalol	3
zotieboy	zotieboy	3
imperiodosnerds	imperiodosnerds	3
loudi_babi	loudi_babi	3
garenabr_	garenabr_	3
paidafac.fc	paidafac.fc	3
breely7	breely7	3
vagabbss	vagabbss	3
loud_millh	loud_millh	3
imperadores_guildaofc	imperadores_guildaofc	3
fbrupdate	fbrupdate	3
guibuenas	guibuenas	3
nerddadepressao	nerddadepressao	3
illegal.minecraft.exe	illegal.minecraft.exe	3
loud_thairga	loud_thairga	3
thiagotinowns	thiagotinowns	3
freefiresorteiosbr	freefiresorteiosbr	3
nobrur.tv	nobrur.tv	3
toniketoficial	toniketoficial	3
fortnitescreative	fortnitescreative	3
stonks.br	stonks.br	3
saporraememe	saporraememe	3
gabrielmaster_	gabrielmaster_	3
sorteiosbr.ff	sorteiosbr.ff	3
cacauzinha_ff	cacauzinha_ff	3
loud_babiy	loud_babiy	3
gabruxona	gabruxona	3
mantovanimv	mantovanimv	3
nzaogames	nzaogames	3
foodsmemes	foodsmemes	3
ykuuro	ykuuro	3
loud_thurzirm	loud_thurzirm	3
loud_thurzirn	loud_thurzirn	3
saporrasabido	saporrasabido	3
metasfreefire2021	metasfreefire2021	3
jovirone1	jovirone1	3
rakinlol	rakinlol	3
gabicattuzzo	gabicattuzzo	3
loud_thurzinm	loud_thurzinm	3
jukeslol	jukeslol	3
vcsabiamemes	vcsabiamemes	3
freefirebrmobile	freefirebrmobile	3
naraxp_	naraxp_	3
goulaarte	goulaarte	3
julianoab	julianoab	3
desenhosputos	desenhosputos	3
s2alinefaria	s2alinefaria	3
loud_leleo	loud_leleo	3
nobruutv	nobruutv	3
4keasyofc	4keasyofc	3
amandacelant	amandacelant	3
tazercraft	tazercraft	3
dailyfortshop	dailyfortshop	3
saporra_radio	saporra_radio	3
paidafac	paidafac	3
msf_clix	msf_clix	3
lazarbeamyt	lazarbeamyt	3
loud_lzinn	loud_lzinn	3
loud.shariin	loud.shariin	3
soquadrinh0s	soquadrinh0s	3
loud_mob	loud_mob	3
weedzao	weedzao	3
lubatv	lubatv	3
loud_skar	loud_skar	3
loud_miih	loud_miih	3
loud_thurzin	loud_thurzin	3
loud.voltan	loud.voltan	3
fazerug	fazerug	3
perifericosgamer	perifericosgamer	3
faahfps	faahfps	3
fighting_games_daily	fighting_games_daily	3
fighters_gen	fighters_gen	3
sngames10	sngames10	3
sociedadegamer	sociedadegamer	3
gamer_lafan	gamer_lafan	3
gamedepressao	gamedepressao	3
kabum.com.br	kabum.com.br	3
games_bit	games_bit	3
snk_neogeo_forever	snk_neogeo_forever	3
clubedovideogame	clubedovideogame	3
foradocontrole_gamer	foradocontrole_gamer	3
curtovideogame	curtovideogame	3
hercules_games	hercules_games	3
retrogamer.brasil	retrogamer.brasil	3
berserk_games	berserk_games	3
gamecomcafe	gamecomcafe	3
rellgamer__	rellgamer__	3
adrianachunli	adrianachunli	3
awaked_bot	awaked_bot	3
gcmgames	gcmgames	3
uva_the_game	uva_the_game	3
lojamundodosgames	lojamundodosgames	3
juliusviloria858	juliusviloria858	3
arcade_fliperama	arcade_fliperama	3
insightgames.ok	insightgames.ok	3
arcadeshock	arcadeshock	3
fluidgame	fluidgame	3
omundodosgames_	omundodosgames_	3
galaxiadosgamers	galaxiadosgamers	3
_lojaskullgamers	_lojaskullgamers	3
near.games	near.games	3
orubegamestudio	orubegamestudio	3
videos_de_jogos	videos_de_jogos	3
umgamer_am	umgamer_am	3
gamer.nostalgia	gamer.nostalgia	3
studiogamebrazil	studiogamebrazil	3
laikagames	laikagames	3
claudio_gamers	claudio_gamers	3
technogamernerd	technogamernerd	3
supergames_indaiatuba	supergames_indaiatuba	3
uma_garota_gamer	uma_garota_gamer	3
tggamesbr	tggamesbr	3
poupagamesoficial	poupagamesoficial	3
games.nostalgicos	games.nostalgicos	3
gamerrmaxx	gamerrmaxx	3
tiagopqdgamer	tiagopqdgamer	3
mundo_gamer06	mundo_gamer06	3
modogamer.com.br	modogamer.com.br	3
oldboygames	oldboygames	3
sabia.disso	sabia.disso	4
felipebecari	felipebecari	4
gudan_ohusky	gudan_ohusky	4
catloversclub	catloversclub	4
fofuradodiaa	fofuradodiaa	4
institutoluisamell	institutoluisamell	4
del.brunolima	del.brunolima	4
sweetcatclub	sweetcatclub	4
astroloucamente	astroloucamente	4
cachorrinhozuero	cachorrinhozuero	4
catsdoingthings	catsdoingthings	4
cheiratoba	cheiratoba	4
lambe_patas	lambe_patas	4
cats_yye	cats_yye	4
cachorross_oficial	cachorross_oficial	4
cheirinho_degato	cheirinho_degato	4
meucao_saudavel	meucao_saudavel	4
zara_pitt	zara_pitt	4
pampet_	pampet_	4
euamogatoss	euamogatoss	4
catioro.reflexivo	catioro.reflexivo	4
catioroamigo	catioroamigo	4
estopinharossi	estopinharossi	4
oficialveinaboa	oficialveinaboa	4
vou_moider	vou_moider	4
diversao_animal	diversao_animal	4
cachorrosamormaior	cachorrosamormaior	4
leandro_silveira_iop	leandro_silveira_iop	4
gatinhosdamari	gatinhosdamari	4
cachorrodigital	cachorrodigital	4
ongdosdoguinhos	ongdosdoguinhos	4
gatosengracados	gatosengracados	4
catiolouco	catiolouco	4
isagateira	isagateira	4
dogitosvida	dogitosvida	4
panyoficial	panyoficial	4
julioeeu	julioeeu	4
bichimbao	bichimbao	4
estopinha.capixaba	estopinha.capixaba	4
amamos_cachorros	amamos_cachorros	4
gatonarede	gatonarede	4
kindcatss	kindcatss	4
meu.amigo.feliz	meu.amigo.feliz	4
instasurreal	instasurreal	4
pantanaloficial	pantanaloficial	4
cachorros_4patas	cachorros_4patas	4
portal.dopet	portal.dopet	4
amadosfelinos	amadosfelinos	4
petinhass	petinhass	4
cachorrinsta	cachorrinsta	4
ocaofuba	ocaofuba	4
alexandrerossi_oficial	alexandrerossi_oficial	4
cuidado_com_o_gato	cuidado_com_o_gato	4
canseidesergato	canseidesergato	4
afonsodpaula	afonsodpaula	4
amorcanino.1	amorcanino.1	4
meuamigocao_ofc	meuamigocao_ofc	4
cat_wiin	cat_wiin	4
cadeiaparamaustratos	cadeiaparamaustratos	4
bella.samoieda	bella.samoieda	4
gatinhosabordo	gatinhosabordo	4
loucosporgatos_oficial	loucosporgatos_oficial	4
sim_amo_meu_pet	sim_amo_meu_pet	4
asjoiasdalu	asjoiasdalu	4
felinosmimados	felinosmimados	4
meuamiguinh	meuamiguinh	4
gatoperaltaoficial	gatoperaltaoficial	4
delegado.matheuslaiola	delegado.matheuslaiola	4
fredcostadep	fredcostadep	4
vocesabiaanimais	vocesabiaanimais	4
animal_felizao	animal_felizao	4
adestreseucao	adestreseucao	4
educandocaes_	educandocaes_	4
o.cachorro.esperto	o.cachorro.esperto	4
respeito.e.amor.pelos.animais	respeito.e.amor.pelos.animais	4
gatomiu	gatomiu	4
bonosurfdog	bonosurfdog	4
meufilhofelino	meufilhofelino	4
gateiros_	gateiros_	4
elefantesbrasil	elefantesbrasil	4
dogbagunceiro	dogbagunceiro	4
felinosironicos	felinosironicos	4
segredo.animal	segredo.animal	4
felineuniverse	felineuniverse	4
livingwithbirds	livingwithbirds	4
focinhosbrasileiros	focinhosbrasileiros	4
amorderuaa	amorderuaa	4
signo_escorpiaonaveia	signo_escorpiaonaveia	4
amomuitocachorros	amomuitocachorros	4
randelsilvaoficial	randelsilvaoficial	4
golden_petstore	golden_petstore	4
bob_marley_goldenretriever	bob_marley_goldenretriever	4
brenabraz	brenabraz	4
tudosobrecachorros	tudosobrecachorros	4
black_catslovers	black_catslovers	4
cachorrinhaartistaofficial	cachorrinhaartistaofficial	4
pequenosprincipes	pequenosprincipes	4
pitsales99	pitsales99	4
mundo_de_gato	mundo_de_gato	4
psolemar	psolemar	4
sape_cao	sape_cao	4
gffkennel	gffkennel	4
zee_dog	zee_dog	4
tenhaumgato	tenhaumgato	4
gatosdoinstagraam	gatosdoinstagraam	4
googlethegolden	googlethegolden	4
ovinosantaines	ovinosantaines	4
blackcats.world	blackcats.world	4
williamgalharde	williamgalharde	4
caes.online	caes.online	4
caopanheirolabra	caopanheirolabra	4
rgdopet	rgdopet	4
amparasilvestre	amparasilvestre	4
gatoevidaoficial	gatoevidaoficial	4
parquedasaves	parquedasaves	4
petvioficial	petvioficial	4
euamooscachorrosof	euamooscachorrosof	4
adoteumbichimcoxim	adoteumbichimcoxim	4
o_capirotinho	o_capirotinho	4
hillspetbr	hillspetbr	4
pingoeninadalmatians	pingoeninadalmatians	4
institutovidalivre	institutovidalivre	4
gateirasdobrasil	gateirasdobrasil	4
protecaoanimalresgate	protecaoanimalresgate	4
happycat.moveisparagatos	happycat.moveisparagatos	4
ongdaspatinhas	ongdaspatinhas	4
otoquinho	otoquinho	4
the.animal_world	the.animal_world	4
gatoprendado	gatoprendado	4
babadegato_oficial	babadegato_oficial	4
gatilmundodosgatos	gatilmundodosgatos	4
milka_theshihtzu	milka_theshihtzu	4
miadodegatoo	miadodegatoo	4
gatos.pretos	gatos.pretos	4
cachorrinhoss_fofinhos	cachorrinhoss_fofinhos	4
arrombadinhosfofos	arrombadinhosfofos	4
iti.malia.doguinhos	iti.malia.doguinhos	4
blackcatiowa	blackcatiowa	4
fatosdesconhecidos	fatosdesconhecidos	5
ideiaseinspiracoe	ideiaseinspiracoe	5
diynobrasil	diynobrasil	5
decorandoereciclando	decorandoereciclando	5
artesanatobrasil	artesanatobrasil	5
artesanatodecorjardim	artesanatodecorjardim	5
artesanatolove	artesanatolove	5
artesanatonew	artesanatonew	5
corte_moldes	corte_moldes	5
costurabelaarte	costurabelaarte	5
clube.dacostureira	clube.dacostureira	5
corte_costuraonline1	corte_costuraonline1	5
corte_costura_off	corte_costura_off	5
corte_costuraonline2	corte_costuraonline2	5
corte_costura_onlinee	corte_costura_onlinee	5
costuracriativa2.0	costuracriativa2.0	5
costurapassoapassomoldes	costurapassoapassomoldes	5
costuracriativa__	costuracriativa__	5
croche_inspiracoes	croche_inspiracoes	5
costurandomoda_	costurandomoda_	5
aprendacosturahoje	aprendacosturahoje	5
artecomcapricho	artecomcapricho	5
palet_decor_	palet_decor_	5
diycasacriativa	diycasacriativa	5
artesanatos_dicas	artesanatos_dicas	5
10ideass	10ideass	5
manualidades1a_	manualidades1a_	5
facavocemesmo	facavocemesmo	5
diydagaveta	diydagaveta	5
diyeideias	diyeideias	5
diyhomebr	diyhomebr	5
artesanato_mundo	artesanato_mundo	5
diydecorr	diydecorr	5
hom3art	hom3art	5
ideiasimpressionantes	ideiasimpressionantes	5
resiliencia_humana	resiliencia_humana	5
bilhetesdeamor	bilhetesdeamor	5
reescrevemos	reescrevemos	5
coisasboasbox	coisasboasbox	5
sentimentos_bons_	sentimentos_bons_	5
coisaboaparaler	coisaboaparaler	5
brisapositiva	brisapositiva	5
sigofrases	sigofrases	5
meditehoje_	meditehoje_	5
sobreautoestima	sobreautoestima	5
trechosdelivro	trechosdelivro	5
sigareciproco	sigareciproco	5
sigagratidao	sigagratidao	5
palavraseverdades	palavraseverdades	5
nuncalitantaverdade	nuncalitantaverdade	5
umbilhetim	umbilhetim	5
voceesabio	voceesabio	5
sos.amorproprio	sos.amorproprio	5
pazeequilibrio	pazeequilibrio	5
psicologiar	psicologiar	5
mulherdevalor.br	mulherdevalor.br	5
osegredooficial	osegredooficial	5
sejaluzbr_	sejaluzbr_	5
365trechoss	365trechoss	5
elaversos	elaversos	5
eimocaofc	eimocaofc	5
princesaoficial_	princesaoficial_	5
opequenomestre	opequenomestre	5
diferentizou	diferentizou	5
fabricadementes	fabricadementes	5
fatosdesconhecido	fatosdesconhecido	5
vocesabi	vocesabi	5
vocesabiavideo	vocesabiavideo	5
mundomisteriosoficial	mundomisteriosoficial	5
_universomisterioso	_universomisterioso	5
casos.ocultos	casos.ocultos	5
curiosoplanetaterra	curiosoplanetaterra	5
megamisterioso	megamisterioso	5
universocuriosoo	universocuriosoo	5
fantasticandoofc	fantasticandoofc	5
fantasticandonerd	fantasticandonerd	5
naosabia	naosabia	5
historiaoculta	historiaoculta	5
mentalidade_milionaria	mentalidade_milionaria	5
historiaocultaphotos	historiaocultaphotos	5
conhecimentoocultoo	conhecimentoocultoo	5
_surpreendente	_surpreendente	5
universo.interessante	universo.interessante	5
sercurioso	sercurioso	5
curiosidadesefatos	curiosidadesefatos	5
umfatoconhecido	umfatoconhecido	5
ateroriadetudo	ateroriadetudo	5
lugarsilencioso	lugarsilencioso	5
grandes.curiosidades	grandes.curiosidades	5
fatosecuriosidade	fatosecuriosidade	5
vcconhece	vcconhece	5
fatosdesconhecidos	fatosdesconhecidos	6
ideiaseinspiracoe	ideiaseinspiracoe	6
resiliencia_humana	resiliencia_humana	6
bilhetesdeamor	bilhetesdeamor	6
reescrevemos	reescrevemos	6
brisapositiva	brisapositiva	6
sigofrases	sigofrases	6
sobreautoestima	sobreautoestima	6
trechosdelivro	trechosdelivro	6
sigareciproco	sigareciproco	6
sigagratidao	sigagratidao	6
palavraseverdades	palavraseverdades	6
umbilhetim	umbilhetim	6
voceesabio	voceesabio	6
sos.amorproprio	sos.amorproprio	6
sejaluzbr_	sejaluzbr_	6
365trechoss	365trechoss	6
elaversos	elaversos	6
princesaoficial_	princesaoficial_	6
opequenomestre	opequenomestre	6
diferentizou	diferentizou	6
fabricadementes	fabricadementes	6
100criterios	100criterios	6
24_horasfeliz	24_horasfeliz	6
24horas_supermotivando	24horas_supermotivando	6
24horasfelizz	24horasfelizz	6
365diasfrases	365diasfrases	6
__felicidade__	__felicidade__	6
_amigasincera	_amigasincera	6
_euansiedade	_euansiedade	6
_gratidao__	_gratidao__	6
_luz_davida	_luz_davida	6
_mensagem_pra_voce	_mensagem_pra_voce	6
_mulherimparavel	_mulherimparavel	6
_pequenasnotaveis	_pequenasnotaveis	6
_simplesassim__	_simplesassim__	6
_sougirassol	_sougirassol	6
_tirinhasdeamor_	_tirinhasdeamor_	6
_vamosrefletir_	_vamosrefletir_	6
_versiculosdiarios	_versiculosdiarios	6
aba__pai	aba__pai	6
acaosemdesculpas	acaosemdesculpas	6
afetotextos	afetotextos	6
ajudavida	ajudavida	6
almacomfrases_	almacomfrases_	6
alquimista.quantico	alquimista.quantico	6
aluzmistica	aluzmistica	6
alvxaro	alvxaro	6
amandafitas	amandafitas	6
amandoporum	amandoporum	6
ambicao_milionaria	ambicao_milionaria	6
ameninadedeus	ameninadedeus	6
amentecriadora	amentecriadora	6
amigos_de_luz	amigos_de_luz	6
amigosdeluz_	amigosdeluz_	6
amordesaturno	amordesaturno	6
anarquiaespiritual	anarquiaespiritual	6
andreferrari	andreferrari	6
anjoseguias	anjoseguias	6
ansiedadepensante	ansiedadepensante	6
aprendameditar	aprendameditar	6
aprender_e_lucrar	aprender_e_lucrar	6
arregacou	arregacou	6
ascifras	ascifras	6
astroloucamente	astroloucamente	6
atitudedegigante	atitudedegigante	6
atitudesvencedoras.av	atitudesvencedoras.av	6
atraidospelacruz_	atraidospelacruz_	6
atraircoisasboas	atraircoisasboas	6
augustocury	augustocury	6
becodopoeta	becodopoeta	6
bemsintonizados	bemsintonizados	6
benditacuca	benditacuca	6
bibliatoododia	bibliatoododia	6
bilhete	bilhete	6
bilhete.diario	bilhete.diario	6
bilhetesdapaz	bilhetesdapaz	6
bilhetesdeprosa	bilhetesdeprosa	6
bilhetesdiariamente	bilhetesdiariamente	6
bilhetesdiarios	bilhetesdiarios	6
bilhetessincero	bilhetessincero	6
blogreacreditar	blogreacreditar	6
bloquinhodadri	bloquinhodadri	6
bomdiacomcarinho	bomdiacomcarinho	6
bonitaefeminina	bonitaefeminina	6
brauliobessa	brauliobessa	6
brcretinas	brcretinas	6
brunopsiquiatra	brunopsiquiatra	6
cafajestando	cafajestando	6
cafe_com_bolo	cafe_com_bolo	6
caiocarneiro	caiocarneiro	6
cantinho_do_amoor_	cantinho_do_amoor_	6
casalperfeyto	casalperfeyto	6
cesar3598	cesar3598	6
cetaloca	cetaloca	6
charlierealista	charlierealista	6
choronaaaa	choronaaaa	6
cicatrizouuu	cicatrizouuu	6
cifras.com.br	cifras.com.br	6
cifrei	cifrei	6
ciumentona	ciumentona	6
claudioduarte.ofc	claudioduarte.ofc	6
clubedamulheralfa	clubedamulheralfa	6
coisa_boa_da_vida	coisa_boa_da_vida	6
coisaboaeh	coisaboaeh	6
coisaboaparaler	coisaboaparaler	6
coisasboasbox	coisasboasbox	6
comamorparadeus	comamorparadeus	6
comecorda	comecorda	6
comediavids	comediavids	6
conhecimentoemvida	conhecimentoemvida	6
conquisteosucesso	conquisteosucesso	6
conscienciaespirituall	conscienciaespirituall	6
coracao.que.ama	coracao.que.ama	6
cortellaoficial	cortellaoficial	6
corujazen	corujazen	6
cretinasanonimas	cretinasanonimas	6
decepcionouu	decepcionouu	6
deebiloide	deebiloide	6
deiveleonardo	deiveleonardo	6
desapaixoneiofc	desapaixoneiofc	6
descrusheiofc	descrusheiofc	6
despertardaconscienciaa	despertardaconscienciaa	6
despertareconsciencia	despertareconsciencia	6
deusogrego	deusogrego	6
deustudoepossivel	deustudoepossivel	6
diariodeumcoracaoo	diariodeumcoracaoo	6
diariosdaviida	diariosdaviida	6
diferentona	diferentona	6
divasdohumor	divasdohumor	6
divasepoderosasoficial	divasepoderosasoficial	6
dnaempreendedor	dnaempreendedor	6
doidinha.oficial	doidinha.oficial	6
doisoumais	doisoumais	6
dono_dos_meus_dias	dono_dos_meus_dias	6
dosebiblicaoficial	dosebiblicaoficial	6
dosedeversos	dosedeversos	6
dra.ajusantos_psi	dra.ajusantos_psi	6
edgardabbehusen	edgardabbehusen	6
eduardogcesar	eduardogcesar	6
educarconscienteoficial	educarconscienteoficial	6
egregoranatural	egregoranatural	6
ei.moca	ei.moca	6
eimocaofc	eimocaofc	6
eimulherofc	eimulherofc	6
ela_milionaria	ela_milionaria	6
emilia9739	emilia9739	6
empreendedores.brasil	empreendedores.brasil	6
eneidaabreutaro	eneidaabreutaro	6
entreparabrisa	entreparabrisa	6
equilibrionapratica	equilibrionapratica	6
escoladadepressao	escoladadepressao	6
escolhiescreveer	escolhiescreveer	6
escritasdedeus	escritasdedeus	6
escritologia	escritologia	6
escritordiegovinicius	escritordiegovinicius	6
escritosmeus	escritosmeus	6
espalhe.amooor	espalhe.amooor	6
espiritualidadepura	espiritualidadepura	6
espiritualidadequantica	espiritualidadequantica	6
espiritualidades	espiritualidades	6
espiritualismos	espiritualismos	6
esporteinterativo	esporteinterativo	6
essediafoifoda	essediafoifoda	6
essencia._feminina	essencia._feminina	6
essencialmentehumana	essencialmentehumana	6
estudantedepressao	estudantedepressao	6
eu.sou.sincera	eu.sou.sincera	6
eu_determino	eu_determino	6
euaconselho	euaconselho	6
euprecisava_dizer	euprecisava_dizer	6
euqueroeupossoeuconsigo01	euqueroeupossoeuconsigo01	6
eusou_capaz	eusou_capaz	6
eusuperior	eusuperior	6
eutogritando	eutogritando	6
exame	exame	6
extraordinaria_mente	extraordinaria_mente	6
ezueira	ezueira	6
faculdadedadepresao	faculdadedadepresao	6
fala_psiquiatra	fala_psiquiatra	6
feeddojr	feeddojr	6
felipedro.art	felipedro.art	6
felipemoller	felipemoller	6
filhasdoreiofc	filhasdoreiofc	6
filosofia.espirita	filosofia.espirita	6
florzinhafrases	florzinhafrases	6
fofoquei	fofoquei	6
forbesbr	forbesbr	6
frase.intelectual	frase.intelectual	6
frase_verso_poesia	frase_verso_poesia	6
frasees_de_inspiracao	frasees_de_inspiracao	6
frases_diarias_oficial	frases_diarias_oficial	6
frases_vc_	frases_vc_	6
frasesdefilosofos	frasesdefilosofos	6
frasesdoinstagrann	frasesdoinstagrann	6
frasesecitacoes_ofc	frasesecitacoes_ofc	6
frasesemfotos	frasesemfotos	6
frasesinstan	frasesinstan	6
frasesnasruas	frasesnasruas	6
frasespichadas	frasespichadas	6
freudoficial	freudoficial	6
gabibrandt	gabibrandt	6
geracaodevalor	geracaodevalor	6
geraldoarufino	geraldoarufino	6
ginaindelicada	ginaindelicada	6
girasorte	girasorte	6
girlsciumes	girlsciumes	6
gisellaconstela	gisellaconstela	6
gotas.de.carinho	gotas.de.carinho	6
gratidaobilhete	gratidaobilhete	6
guiferreira	guiferreira	6
harmoniaevidaplena	harmoniaevidaplena	6
homemdevalor.br	homemdevalor.br	6
homemnapratica	homemnapratica	6
hooponopono.cura	hooponopono.cura	6
hooponopono_sougrata	hooponopono_sougrata	6
hooponoponobr	hooponoponobr	6
hooponoponofortal	hooponoponofortal	6
humorsecretoofc	humorsecretoofc	6
iandealbuquerque	iandealbuquerque	6
ideiaseinspiracoes	ideiaseinspiracoes	6
ideiasparatatuagens	ideiasparatatuagens	6
indiretasma	indiretasma	6
infomoney	infomoney	6
inspiraa.sol	inspiraa.sol	6
instadoshivao	instadoshivao	6
irmazuleideoficial	irmazuleideoficial	6
ironicadisney	ironicadisney	6
isaiaslvas	isaiaslvas	6
janemotiva.oficial	janemotiva.oficial	6
jhowsiel	jhowsiel	6
joeljota	joeljota	6
jovemcristaoig	jovemcristaoig	6
kaisser	kaisser	6
kanalmentequantica	kanalmentequantica	6
karenkardasha	karenkardasha	6
kzureto	kzureto	6
lei_da_atracao_mudandovidas	lei_da_atracao_mudandovidas	6
lei_da_atracao_napratica	lei_da_atracao_napratica	6
lei_da_gratidao	lei_da_gratidao	6
lembreidevoceofc	lembreidevoceofc	6
lembretefrases	lembretefrases	6
levezanaalma_	levezanaalma_	6
li.gostei.compart	li.gostei.compart	6
lifeonadraw	lifeonadraw	6
ligamotivacional	ligamotivacional	6
lindamensagemdodia	lindamensagemdodia	6
lise_carlotta	lise_carlotta	6
lucasbilhetes	lucasbilhetes	6
lugardafama	lugardafama	6
luz_prosperidade_amor	luz_prosperidade_amor	6
machucava	machucava	6
manaleoa	manaleoa	6
mauradealbanesi	mauradealbanesi	6
mayracardi	mayracardi	6
meditacaohooponopono	meditacaohooponopono	6
meditantes	meditantes	6
meditehoje_	meditehoje_	6
melancia_blue_frases	melancia_blue_frases	6
meninasfrases	meninasfrases	6
mensagem_de_carinho	mensagem_de_carinho	6
mensagens_de_bom_dia	mensagens_de_bom_dia	6
mensagensdeluzereflexoes	mensagensdeluzereflexoes	6
mentalidade_milionaria	mentalidade_milionaria	6
mentalidade_quantica	mentalidade_quantica	6
mentalidade_visionaria	mentalidade_visionaria	6
mentalidadecriadora	mentalidadecriadora	6
mentedesucessoo	mentedesucessoo	6
menteempreendedora	menteempreendedora	6
mentemilionaria	mentemilionaria	6
mentesimplacaveis	mentesimplacaveis	6
mentesquanticas	mentesquanticas	6
mentor_milionario	mentor_milionario	6
mesaquanticaestelar.online	mesaquanticaestelar.online	6
metamorfrases_	metamorfrases_	6
midianinja	midianinja	6
millarabisca	millarabisca	6
mimolinoficial	mimolinoficial	6
minhamelhorversaofrases	minhamelhorversaofrases	6
monjacoen	monjacoen	6
motivacao24h	motivacao24h	6
motivacaoemfrases	motivacaoemfrases	6
motivacoesdasruas	motivacoesdasruas	6
movaomundo	movaomundo	6
mulher_conselheira_	mulher_conselheira_	6
mulherambiciosa	mulherambiciosa	6
mulherbilionaria.br	mulherbilionaria.br	6
mulherde.valores	mulherde.valores	6
mulherde30405060	mulherde30405060	6
mulherderespeito.br	mulherderespeito.br	6
mulherdevalor.br	mulherdevalor.br	6
mulherdiferente_	mulherdiferente_	6
mulherempreendedora.br	mulherempreendedora.br	6
mulheres.empreendedoras.br	mulheres.empreendedoras.br	6
mulheres_maduras	mulheres_maduras	6
mulheresbemsucedidas	mulheresbemsucedidas	6
mulheresde40anos	mulheresde40anos	6
mulheresdeatitude.br	mulheresdeatitude.br	6
mulheresdenegocios_br	mulheresdenegocios_br	6
mulheresempoderadas_felizes	mulheresempoderadas_felizes	6
mulherguerreira.br	mulherguerreira.br	6
mulherpoderosa.br	mulherpoderosa.br	6
mulherpoderosa__	mulherpoderosa__	6
musadosmeme	musadosmeme	6
nacionalissimo	nacionalissimo	6
namasteluzeamor	namasteluzeamor	6
nathaliaarcuri	nathaliaarcuri	6
naturalvibe	naturalvibe	6
nuncalitantaverdade	nuncalitantaverdade	6
oamorcitou	oamorcitou	6
oamorof	oamorof	6
obilhetesincero	obilhetesincero	6
obrigadadenada	obrigadadenada	6
ocafezinho	ocafezinho	6
ocaminhantedaluz_	ocaminhantedaluz_	6
odecepcionado	odecepcionado	6
oegopira	oegopira	6
oemputecido	oemputecido	6
oficial1967	oficial1967	6
oficial1978	oficial1978	6
omeditante	omeditante	6
onda.quantica	onda.quantica	6
opequenogaroto	opequenogaroto	6
opoeteiro	opoeteiro	6
os_encantos_da_vida	os_encantos_da_vida	6
osegredooficial	osegredooficial	6
osegredoquantico	osegredoquantico	6
oshobrasil	oshobrasil	6
otrechodelivro	otrechodelivro	6
padremarcelorossi	padremarcelorossi	6
palavra_transformadora	palavra_transformadora	6
palavraparahoje	palavraparahoje	6
pandocadesign	pandocadesign	6
paz.amor_fe	paz.amor_fe	6
pazdoeu_	pazdoeu_	6
pazeequilibrio	pazeequilibrio	6
pegadicabrasil	pegadicabrasil	6
pensadorsincero	pensadorsincero	6
pensamentos.diarios.e.sinceros	pensamentos.diarios.e.sinceros	6
pensandoalto8	pensandoalto8	6
pequenooshabitos	pequenooshabitos	6
perrengue_chique	perrengue_chique	6
pilulascoloridas	pilulascoloridas	6
planetajovem	planetajovem	6
poderdoamorproprio	poderdoamorproprio	6
poderfeminino.br	poderfeminino.br	6
poesiadasruas	poesiadasruas	6
poesiapradois	poesiapradois	6
poesiaprazer	poesiaprazer	6
poetadosmuros	poetadosmuros	6
portaladministradores	portaladministradores	6
portalg1	portalg1	6
posteifrase	posteifrase	6
precisavaescrever	precisavaescrever	6
preparei	preparei	6
projetomilhao	projetomilhao	6
prosperidadeepaz	prosperidadeepaz	6
psicologiar	psicologiar	6
psipamela	psipamela	6
psitarjapreta	psitarjapreta	6
putzfaleii	putzfaleii	6
quantica_e_espiritualidade	quantica_e_espiritualidade	6
quarentantos	quarentantos	6
quebrandootabu	quebrandootabu	6
quemusicaboa	quemusicaboa	6
quintalpositivo	quintalpositivo	6
rafaelcunha	rafaelcunha	6
rafaeluccman	rafaeluccman	6
recanto_dos_pensamentos	recanto_dos_pensamentos	6
reduzaestresse	reduzaestresse	6
reescrevendoamor	reescrevendoamor	6
refletir__	refletir__	6
reflexaopadrefabiodemelo	reflexaopadrefabiodemelo	6
reflita_antes	reflita_antes	6
reikiando	reikiando	6
relateibilhetes	relateibilhetes	6
relatizou	relatizou	6
renallidaoficial	renallidaoficial	6
resgatedaalma	resgatedaalma	6
resilienciaepazz	resilienciaepazz	6
rick_chesther	rick_chesther	6
riscoserabiscos1	riscoserabiscos1	6
romananovais	romananovais	6
romanticos	romanticos	6
rosaecor.oficial	rosaecor.oficial	6
sabrinabragaoficial	sabrinabragaoficial	6
sacadademestre	sacadademestre	6
safadocitou	safadocitou	6
safadodesejo	safadodesejo	6
salto_da_prosperidade	salto_da_prosperidade	6
sarandocoracao	sarandocoracao	6
sarcasmofeminino	sarcasmofeminino	6
seejafoda	seejafoda	6
segredodameditacao	segredodameditacao	6
segredosdasvendas	segredosdasvendas	6
seguetrechos	seguetrechos	6
seja.luz.e.amor	seja.luz.e.amor	6
sejaa_amoor	sejaa_amoor	6
sejahomem.oficial	sejahomem.oficial	6
sejaluzversos	sejaluzversos	6
sejaposittivo	sejaposittivo	6
sentimentos_bons_	sentimentos_bons_	6
sentoavara	sentoavara	6
seuamigoguru	seuamigoguru	6
sigacitacoes	sigacitacoes	6
sigocomfe	sigocomfe	6
sigoespalhandoamor	sigoespalhandoamor	6
sinceridadeescrita	sinceridadeescrita	6
sintoniado.amor	sintoniado.amor	6
sintonizoufrases	sintonizoufrases	6
smsindelicado	smsindelicado	6
soabusada	soabusada	6
sobrevoceoficial	sobrevoceoficial	6
soldadaferida	soldadaferida	6
soldadoferido	soldadoferido	6
solteirinhaa	solteirinhaa	6
solterissimas	solterissimas	6
somos.om	somos.om	6
sonhegrande	sonhegrande	6
soquadrinh0s	soquadrinh0s	6
sorteiosdecasa	sorteiosdecasa	6
sou_psicologo_comuitorgulho	sou_psicologo_comuitorgulho	6
souironicooficial	souironicooficial	6
soulequilibre	soulequilibre	6
soureciproco	soureciproco	6
sousemvergonha	sousemvergonha	6
startando.se	startando.se	6
statusfelizz	statusfelizz	6
statusfrases	statusfrases	6
suamentesuavida	suamentesuavida	6
superouuu	superouuu	6
suricateseboso	suricateseboso	6
tadashikadomoto	tadashikadomoto	6
taradasanonimas	taradasanonimas	6
teinspireimulher	teinspireimulher	6
templodamente	templodamente	6
terapia_interior	terapia_interior	6
terapiafazbem	terapiafazbem	6
textosamorproprio	textosamorproprio	6
thamireshauch	thamireshauch	6
thiago.nigro	thiago.nigro	6
tiagofonsecaoficial	tiagofonsecaoficial	6
tiagogreis	tiagogreis	6
tipicodejovem	tipicodejovem	6
tobemisso	tobemisso	6
tocontando	tocontando	6
tofuxicando	tofuxicando	6
togritando	togritando	6
tonemaiuai	tonemaiuai	6
tonsdeverso	tonsdeverso	6
tramasepensamentos	tramasepensamentos	6
transformeasuavida_	transformeasuavida_	6
trechos	trechos	6
trechosdeumpapel	trechosdeumpapel	6
trechosemlivros	trechosemlivros	6
trechosquelibertam	trechosquelibertam	6
tsoah	tsoah	6
tumbrlizando	tumbrlizando	6
uimulherao	uimulherao	6
umabiografia	umabiografia	6
umaflorparaela	umaflorparaela	6
umafrasepararecordar	umafrasepararecordar	6
umamorsafado	umamorsafado	6
umanordestinacitou	umanordestinacitou	6
umcartao	umcartao	6
umcartaozinho	umcartaozinho	6
umfilmemedisse	umfilmemedisse	6
universo_de_amor	universo_de_amor	6
universoquantico_	universoquantico_	6
vendedoraguia	vendedoraguia	6
verdadesparaelas	verdadesparaelas	6
victorofern	victorofern	6
vida_deus_oracao	vida_deus_oracao	6
vidaegratidao	vidaegratidao	6
vidasdeescritor	vidasdeescritor	6
vivapradeus	vivapradeus	6
viver_pra_ser_felizz	viver_pra_ser_felizz	6
viverdevendas	viverdevendas	6
voceeainspiracao	voceeainspiracao	6
vocesabia	vocesabia	6
wendellcarvalho	wendellcarvalho	6
reinorubronegro	reinorubronegro	7
golsdosaopaulo	golsdosaopaulo	7
acontecefutebol	acontecefutebol	7
urubug__	urubug__	7
flanortenews	flanortenews	7
futtmais	futtmais	7
brasileiraofeminino_	brasileiraofeminino_	7
sangueerubronegro	sangueerubronegro	7
porcoalviverde1914	porcoalviverde1914	7
cg_club	cg_club	7
noticias_do_tricolor	noticias_do_tricolor	7
teamroping	teamroping	7
_urubuzueiro	_urubuzueiro	7
hornet_br	hornet_br	7
douglasbaggio	douglasbaggio	7
lojadabrutalidade	lojadabrutalidade	7
o_kanal_nao_tem_nacional_	o_kanal_nao_tem_nacional_	7
brasilcorridas	brasilcorridas	7
cavalocrioulooficial	cavalocrioulooficial	7
ekiprozetaoficial	ekiprozetaoficial	7
neymarjrmilgrauu	neymarjrmilgrauu	7
olivierebsb	olivierebsb	7
oseinhadabahia	oseinhadabahia	7
oeurys	oeurys	7
mariaeuseiquevocetreme	mariaeuseiquevocetreme	7
passeiosembonitoms	passeiosembonitoms	7
sebastianrojasphoto	sebastianrojasphoto	7
rubronegrolove	rubronegrolove	7
fabio_gigante_celeste	fabio_gigante_celeste	7
vaqueironasela	vaqueironasela	7
canalhorsesports	canalhorsesports	7
mengoarte	mengoarte	7
luquinhawheeling	luquinhawheeling	7
rungustavorun	rungustavorun	7
st_spfc	st_spfc	7
eduardo_purapesca	eduardo_purapesca	7
lucaskokapenteado	lucaskokapenteado	7
biel44k	biel44k	7
garenabrasil	garenabrasil	7
meups_oficial	meups_oficial	7
suzukimotosbrasil	suzukimotosbrasil	7
clube_vw	clube_vw	7
nettocnn	nettocnn	7
sil_polita	sil_polita	7
pedaleria.oficial	pedaleria.oficial	7
alemaodemaresias	alemaodemaresias	7
ecosys_lagos_ornamentais	ecosys_lagos_ornamentais	7
lejardincaldas	lejardincaldas	7
fluminenseforte	fluminenseforte	7
trilheirosmg	trilheirosmg	7
jgmartini	jgmartini	7
nascisantista	nascisantista	7
danielperrone	danielperrone	7
eusoucruzeiro	eusoucruzeiro	7
timedopovooficial	timedopovooficial	7
jogos.aovivo	jogos.aovivo	7
trescoreseumapaixao	trescoreseumapaixao	7
treinamentofaustino68	treinamentofaustino68	7
g.r.c.torcidajovemdoflamengo	g.r.c.torcidajovemdoflamengo	7
tatapelegrino	tatapelegrino	7
jessycadograu	jessycadograu	7
artbella.piscinas	artbella.piscinas	7
diegogaldi23	diegogaldi23	7
verdaodepressao	verdaodepressao	7
cavalos_e_frases_	cavalos_e_frases_	7
ibrahracing	ibrahracing	7
torcidajovem_oficial	torcidajovem_oficial	7
desafiobrou	desafiobrou	7
diarioceleste	diarioceleste	7
moldadasaferro	moldadasaferro	7
timaonamemoria	timaonamemoria	7
gaveagol_	gaveagol_	7
madeiraperformance	madeiraperformance	7
os.craques	os.craques	7
mercadodotimao	mercadodotimao	7
resenhatricolorspfc	resenhatricolorspfc	7
inspiracaopiscina	inspiracaopiscina	7
talysson_melo	talysson_melo	7
flalove2.0	flalove2.0	7
gefakenews	gefakenews	7
noticias_nf	noticias_nf	7
ronaldinhus	ronaldinhus	7
lincolnfe	lincolnfe	7
gabymotocross	gabymotocross	7
carlosatleta11	carlosatleta11	7
branca.s2	branca.s2	7
interligadossci	interligadossci	7
tretadosrealities_rj	tretadosrealities_rj	7
teniscerto	teniscerto	7
golfclube_	golfclube_	7
rindodagalinhada_oficial	rindodagalinhada_oficial	7
boleirosdafirma	boleirosdafirma	7
marinesportsfishing	marinesportsfishing	7
oficial_hornet	oficial_hornet	7
hornetmeumundo	hornetmeumundo	7
verdaolive	verdaolive	7
victorioso7	victorioso7	7
zaionalexandreoficial	zaionalexandreoficial	7
bubudograu_	bubudograu_	7
daanyb_	daanyb_	7
familiaitabunacity	familiaitabunacity	7
montadinhas_das_quebrada	montadinhas_das_quebrada	7
zueira.gremista	zueira.gremista	7
vianaracing	vianaracing	7
reguaraciaba	reguaraciaba	7
porcothug	porcothug	7
espacorubronegro	espacorubronegro	7
instafla	instafla	7
lucaspedrosa94	lucaspedrosa94	7
futebolnostalgia	futebolnostalgia	7
vaquejadanoestilo	vaquejadanoestilo	7
turbo_e_vida_	turbo_e_vida_	7
duasrodasbr	duasrodasbr	7
lafuriaguild	lafuriaguild	7
lucasdunka34	lucasdunka34	7
artimaobr	artimaobr	7
mxlifebr	mxlifebr	7
sccorinthians.futsal	sccorinthians.futsal	7
joaopedro_cajuprabaixo	joaopedro_cajuprabaixo	7
cartol4ndo	cartol4ndo	7
radiopachola	radiopachola	7
coachmcoelho	coachmcoelho	7
vascainosunidos	vascainosunidos	7
dragoesdareal1984	dragoesdareal1984	7
oggi_bikes	oggi_bikes	7
fefurlan	fefurlan	7
loucos_motocross	loucos_motocross	7
careca360	careca360	7
nilsinho8	nilsinho8	7
surftiras	surftiras	7
maicon_bianchi_oficial	maicon_bianchi_oficial	7
nacao_5_estrelas	nacao_5_estrelas	7
verdao.info	verdao.info	7
harastavares	harastavares	7
fut.palmeirense	fut.palmeirense	7
colunadofla	colunadofla	7
mafiaazuloficial	mafiaazuloficial	7
futebolzueiropa	futebolzueiropa	7
fazendaviannaoficial	fazendaviannaoficial	7
transfut_center	transfut_center	7
fla_newss	fla_newss	7
xt.660.sonho	xt.660.sonho	7
basedopalmeiras	basedopalmeiras	7
familiagolfclub	familiagolfclub	7
santosfc_futebol	santosfc_futebol	7
renato7portaluppi	renato7portaluppi	7
gaviao_da_depre	gaviao_da_depre	7
igorpsz	igorpsz	7
pilotosdograu	pilotosdograu	7
wavesbr	wavesbr	7
patinscascavel	patinscascavel	7
canaldebike	canaldebike	7
futebolcoruja	futebolcoruja	7
mafiaopaleira	mafiaopaleira	7
sargento_ofc	sargento_ofc	7
universotricolor	universotricolor	7
memoriarubronegra	memoriarubronegra	7
tricolordosul_	tricolordosul_	7
osboccapalmeiras	osboccapalmeiras	7
siganacaorubronegra	siganacaorubronegra	7
esa.exercito	esa.exercito	7
seucatimba	seucatimba	7
oporconato	oporconato	7
trechoscruzeiro	trechoscruzeiro	7
flaofficial_m	flaofficial_m	7
galohojeesempre	galohojeesempre	7
conte.comigo.mengao	conte.comigo.mengao	7
quartodemilhashow	quartodemilhashow	7
tricolornet	tricolornet	7
futeboldechinelo	futeboldechinelo	7
paitomotors	paitomotors	7
ous_official	ous_official	7
pregododia	pregododia	7
antonio_cipolini	antonio_cipolini	7
verdao.gols	verdao.gols	7
gurudocartola	gurudocartola	7
praquempedala	praquempedala	7
southamericagalo	southamericagalo	7
gabrielpastori	gabrielpastori	7
futcrewbr	futcrewbr	7
gersonsantossig	gersonsantossig	7
nelson.nakamura	nelson.nakamura	7
xt66_foguete	xt66_foguete	7
peopleontour	peopleontour	7
fla.online	fla.online	7
harasmastruzcomleite	harasmastruzcomleite	7
urubu_da_massa	urubu_da_massa	7
230brasil	230brasil	7
tavares160	tavares160	7
plantaovascaino	plantaovascaino	7
sfcalvinegroriginal	sfcalvinegroriginal	7
mundodasarmas	mundodasarmas	7
noticiasdoflamengo	noticiasdoflamengo	7
lucaskerkhoff	lucaskerkhoff	7
alineandradefit	alineandradefit	7
canalfefrancopro	canalfefrancopro	7
familiacajacity	familiacajacity	7
cassiomilgrauu	cassiomilgrauu	7
4keasyofc	4keasyofc	7
katiamello909	katiamello909	7
nubiadiias	nubiadiias	7
tonh_miller	tonh_miller	7
cupim_de_ferro46	cupim_de_ferro46	7
polacomotos	polacomotos	7
elenaodisseisso	elenaodisseisso	7
jogouondeferaaa	jogouondeferaaa	7
luma_mtb	luma_mtb	7
leoninasfec	leoninasfec	7
whoscosta	whoscosta	7
legendscupbrasil	legendscupbrasil	7
faelslim	faelslim	7
futebol_da_depressao	futebol_da_depressao	7
g.martonn	g.martonn	7
loudfc	loudfc	7
guilda_golpistas	guilda_golpistas	7
popularoficial	popularoficial	7
stephaniesilveira_fas	stephaniesilveira_fas	7
ivanpokemon012	ivanpokemon012	7
paulophilippe	paulophilippe	7
pldadepressao	pldadepressao	7
_gremiocopeiro	_gremiocopeiro	7
jovemsport	jovemsport	7
marivolei	marivolei	7
frasescoringao	frasescoringao	7
fagnerh	fagnerh	7
godesportsoficial	godesportsoficial	7
odsbronze	odsbronze	7
bope_oficialff	bope_oficialff	7
paulinha1895	paulinha1895	7
100_clubismo	100_clubismo	7
cannondalebr	cannondalebr	7
marcelobolinha	marcelobolinha	7
lucas_bzk	lucas_bzk	7
rossi_mrmotos	rossi_mrmotos	7
santosplayoficial	santosplayoficial	7
porcomilgrauu	porcomilgrauu	7
cartola_dicasfc	cartola_dicasfc	7
leticiabeppler	leticiabeppler	7
nicolas10oficial	nicolas10oficial	7
boraleao	boraleao	7
revoltalol	revoltalol	7
torcidagoloud	torcidagoloud	7
vossocanal.ofc	vossocanal.ofc	7
bbdebate	bbdebate	7
futevoleidepressao	futevoleidepressao	7
entreaspasfutebol	entreaspasfutebol	7
cesar_greco	cesar_greco	7
paparazzorubronegro	paparazzorubronegro	7
_thauanteixeira	_thauanteixeira	7
golcontraoficial	golcontraoficial	7
natypotira	natypotira	7
hepta_de_respeito	hepta_de_respeito	7
carolana15	carolana15	7
spfc	spfc	7
corinthiosidades	corinthiosidades	7
weslaynepaniago	weslaynepaniago	7
rodolfopereiragrau	rodolfopereiragrau	7
noticiadogalo	noticiadogalo	7
naovemdeprimeira_	naovemdeprimeira_	7
_magrezza	_magrezza	7
fabio_baca	fabio_baca	7
cr7.o_lendario	cr7.o_lendario	7
caio5511	caio5511	7
jojoca	jojoca	7
loucosporarmas	loucosporarmas	7
cavalinhodocec	cavalinhodocec	7
boleirofrases	boleirofrases	7
legadaodamassa	legadaodamassa	7
betingamer	betingamer	7
bronziocre	bronziocre	7
instaplaysss	instaplaysss	7
fkszika	fkszika	7
adenormilgrau	adenormilgrau	7
digothuler3.0	digothuler3.0	7
henriquedallemos	henriquedallemos	7
chefaozp	chefaozp	7
cearamilgrau	cearamilgrau	7
cenaslamentaveis	cenaslamentaveis	7
l0peszinh0	l0peszinh0	7
matheusgonze1	matheusgonze1	7
igorrezende12	igorrezende12	7
casimiro	casimiro	7
davidalmonacid	davidalmonacid	7
jukanalha	jukanalha	7
ocantodastorcidas	ocantodastorcidas	7
futeousadia	futeousadia	7
meninosonhad0r	meninosonhad0r	7
fcrogerioceni	fcrogerioceni	7
bolafora_oficial	bolafora_oficial	7
tocaprobira	tocaprobira	7
fanaticosporfutebol_	fanaticosporfutebol_	7
thaleshenriquecg	thaleshenriquecg	7
futirinhas	futirinhas	7
jorgejesusdadepressao	jorgejesusdadepressao	7
manchaverdetorcida	manchaverdetorcida	7
curiosidadedabola	curiosidadedabola	7
oficialrogerioceni	oficialrogerioceni	7
andressafontinele	andressafontinele	7
vocesabiafutebol	vocesabiafutebol	7
fabianagrafitheira	fabianagrafitheira	7
leesteves8	leesteves8	7
joaorossini7	joaorossini7	7
brazaa02	brazaa02	7
vgzinnn	vgzinnn	7
arthur.teles27	arthur.teles27	7
flamengodadepressao	flamengodadepressao	7
patrickblackoutz	patrickblackoutz	7
japa.04	japa.04	7
shottz_ff	shottz_ff	7
soltaram	soltaram	7
neysilvaoficiall	neysilvaoficiall	7
enzotorcedor	enzotorcedor	7
libertadadepreoficial	libertadadepreoficial	7
didafreestyle	didafreestyle	7
dudaviegas1312	dudaviegas1312	7
brunonazario10_oficial	brunonazario10_oficial	7
geromeloficialfc	geromeloficialfc	7
maykoonsantos	maykoonsantos	7
vemprofut_oficial	vemprofut_oficial	7
corinthians_milgrau	corinthians_milgrau	7
theblurbarbosa	theblurbarbosa	7
byancabrasil	byancabrasil	7
robertoheuchayer90	robertoheuchayer90	7
yansondahl	yansondahl	7
brfeminino	brfeminino	7
wellington_martinsoficial	wellington_martinsoficial	7
sulamericana	sulamericana	7
barbarapcoelho	barbarapcoelho	7
alextsengoficial	alextsengoficial	7
rdinamite10	rdinamite10	7
mineirao	mineirao	7
americafcnatal	americafcnatal	7
futebolinterior	futebolinterior	7
fazendaboavista	fazendaboavista	7
gauchodageral	gauchodageral	7
redcanids	redcanids	7
giulirp	giulirp	7
ademirquintino	ademirquintino	7
nbb	nbb	7
bjjstarsoficial	bjjstarsoficial	7
brasilironman	brasilironman	7
nivaldoprieto	nivaldoprieto	7
coritiba	coritiba	7
yamahabrasil	yamahabrasil	7
andersonaguia	andersonaguia	7
zelove9	zelove9	7
estadioniltonsantos	estadioniltonsantos	7
galoffeminino	galoffeminino	7
emilylima_oficial	emilylima_oficial	7
yarafantoni	yarafantoni	7
kabumesports	kabumesports	7
moraesadriano	moraesadriano	7
esquivafalcao	esquivafalcao	7
babibeluco	babibeluco	7
marcelsturmer	marcelsturmer	7
maurine	maurine	7
fabioazevedotv	fabioazevedotv	7
underarmourbrasil	underarmourbrasil	7
bebeto7	bebeto7	7
jairinho_010	jairinho_010	7
arenamrv	arenamrv	7
ricardorocha94	ricardorocha94	7
canalpremiere	canalpremiere	7
luizcarlosjnr	luizcarlosjnr	7
samircaetano	samircaetano	7
cassiocortes	cassiocortes	7
superdriftbrasil	superdriftbrasil	7
pauloricardo	pauloricardo	7
fabiolavoleyoficial	fabiolavoleyoficial	7
kawasakibrasiloficial	kawasakibrasiloficial	7
thiagocamarao	thiagocamarao	7
muller7oficial	muller7oficial	7
sertoes	sertoes	7
lolesportsbr	lolesportsbr	7
pablocastro	pablocastro	7
fabsimoes	fabsimoes	7
copadonordeste	copadonordeste	7
wendelllira	wendelllira	7
wslbrasil	wslbrasil	7
hernanebrocador	hernanebrocador	7
taynahanada	taynahanada	7
caiquefranca_	caiquefranca_	7
konamibrasil	konamibrasil	7
magnusfutsal	magnusfutsal	7
maluschwaizer	maluschwaizer	7
oficialguilherme10	oficialguilherme10	7
maracana	maracana	7
blackdragonsteam	blackdragonsteam	7
cayo_tenorio02	cayo_tenorio02	7
oficialarouca5	oficialarouca5	7
pauloviniciuscoelho	pauloviniciuscoelho	7
miguelpuposurf	miguelpuposurf	7
sociogigante	sociogigante	7
benjaminbackoficial	benjaminbackoficial	7
sensebike	sensebike	7
renaultbrasil	renaultbrasil	7
clubedoremo	clubedoremo	7
copadobrasil	copadobrasil	7
monicahickmann	monicahickmann	7
andrellmourao	andrellmourao	7
danyhypolito	danyhypolito	7
goiasoficial	goiasoficial	7
cartolafc	cartolafc	7
judivansilva	judivansilva	7
leozagueiro	leozagueiro	7
f.bastos06	f.bastos06	7
crboficial	crboficial	7
leandrorafe	leandrorafe	7
ribeirogabriela	ribeirogabriela	7
ariele_8	ariele_8	7
osdonosdabola	osdonosdabola	7
marlonprezotti	marlonprezotti	7
gabizanottid	gabizanottid	7
fabiolafariaandrade	fabiolafariaandrade	7
be90oficial	be90oficial	7
pbrbrazil	pbrbrazil	7
mauronaves	mauronaves	7
zinho	zinho	7
athleticoparanaense	athleticoparanaense	7
viniciusftv	viniciusftv	7
jcbrant	jcbrant	7
adenizia05	adenizia05	7
csaoficial	csaoficial	7
nauticope	nauticope	7
chicao_03	chicao_03	7
sassarocha	sassarocha	7
paulomiranda_3	paulomiranda_3	7
sadacruzeiro	sadacruzeiro	7
sheillacastro	sheillacastro	7
valdiviamagico_oficial21	valdiviamagico_oficial21	7
confiancaoficial	confiancaoficial	7
jujugol	jujugol	7
sportrecife	sportrecife	7
cearasc	cearasc	7
aloisiochulapa	aloisiochulapa	7
boliviazica	boliviazica	7
romulo	romulo	7
hevertonfutebol	hevertonfutebol	7
adrianodesouza	adrianodesouza	7
raisasimplic	raisasimplic	7
corinthiansnabase	corinthiansnabase	7
controle2oficial	controle2oficial	7
marcelinhocariocaoficial	marcelinhocariocaoficial	7
wellingtongarcia21	wellingtongarcia21	7
adaorosatattoo	adaorosatattoo	7
meutimao	meutimao	7
ericgranado	ericgranado	7
diegofreestyle	diegofreestyle	7
jean.carlos92	jean.carlos92	7
premioesportsbr	premioesportsbr	7
chapecoensereal	chapecoensereal	7
fluminensefc	fluminensefc	7
espnbrasil	espnbrasil	7
leo_santos	leo_santos	7
_matheusmatias98	_matheusmatias98	7
08_henrique	08_henrique	7
jonastoro_	jonastoro_	7
r_marques	r_marques	7
lucaschumbo	lucaschumbo	7
joaolucashaf	joaolucashaf	7
edilsonoficial33	edilsonoficial33	7
nbabrasil	nbabrasil	7
torcidaindependenteoficial	torcidaindependenteoficial	7
corinthiansfutebolfeminino	corinthiansfutebolfeminino	7
arthur	arthur	7
thaisinhaduarte	thaisinhaduarte	7
erikotinhac	erikotinhac	7
wcasagrandejr	wcasagrandejr	7
allianzparque	allianzparque	7
renanvictor_04	renanvictor_04	7
richarlyson	richarlyson	7
ducker_gremio	ducker_gremio	7
crivelari_gi	crivelari_gi	7
fegaray	fegaray	7
santacruzfc	santacruzfc	7
tandaracaixeta	tandaracaixeta	7
concaoficial	concaoficial	7
furiagg	furiagg	7
gmantuan	gmantuan	7
diegosouzads87	diegosouzads87	7
geraldogremiop10	geraldogremiop10	7
sisidy	sisidy	7
lucas.gallina	lucas.gallina	7
edudracenaoficial	edudracenaoficial	7
uolesporte	uolesporte	7
caiobaribeiro	caiobaribeiro	7
ecbahia	ecbahia	7
nakagima	nakagima	7
felipe.jonatan	felipe.jonatan	7
nflbrasil	nflbrasil	7
goleirojean95	goleirojean95	7
eigames	eigames	7
cbrait	cbrait	7
amandinhafutsal10	amandinhafutsal10	7
tulinho	tulinho	7
luansilva_34	luansilva_34	7
rodrigoha	rodrigoha	7
junior	junior	7
mathheusdantas	mathheusdantas	7
leomoura23	leomoura23	7
alexavier	alexavier	7
daherthaisa	daherthaisa	7
taynahespinoza	taynahespinoza	7
pedrinho_77	pedrinho_77	7
david_braz	david_braz	7
bill_f99	bill_f99	7
luisrobertoreal	luisrobertoreal	7
botafogo	botafogo	7
gustavo_villani	gustavo_villani	7
lucassantos	lucassantos	7
diegopituca	diegopituca	7
oledobrasil	oledobrasil	7
hugomoura98	hugomoura98	7
selecaofemininadefutebol	selecaofemininadefutebol	7
marcossjunior95	marcossjunior95	7
diegofaustino68	diegofaustino68	7
santosfc	santosfc	7
mauricioborgesmano	mauricioborgesmano	7
igor.vinicius	igor.vinicius	7
osvaldolf17	osvaldolf17	7
flaesports	flaesports	7
desolaoficial	desolaoficial	7
joaobarion	joaobarion	7
e.felipeoficial	e.felipeoficial	7
rony7oficial	rony7oficial	7
igorrabellooficial	igorrabellooficial	7
10neto	10neto	7
jguilhermefox	jguilhermefox	7
andressinha95	andressinha95	7
eduardosasha	eduardosasha	7
goleiro_rafael	goleiro_rafael	7
vascodagama	vascodagama	7
patrickchoco	patrickchoco	7
mendoncaromulo	mendoncaromulo	7
douglas_10doga	douglas_10doga	7
tchetche	tchetche	7
vh.oficial	vh.oficial	7
fabiocarille	fabiocarille	7
essediafoilouco	essediafoilouco	7
gilbertosouzajr9	gilbertosouzajr9	7
fernandoprassoficial	fernandoprassoficial	7
junior_maestro_5	junior_maestro_5	7
lucianoamaral	lucianoamaral	7
magicjadson	magicjadson	7
ronaldogiovaneli	ronaldogiovaneli	7
ribamar_97	ribamar_97	7
linfnx	linfnx	7
leagueoflegendsbrasil	leagueoflegendsbrasil	7
leoduarte_43	leoduarte_43	7
dodopires	dodopires	7
lucaspiton_	lucaspiton_	7
fabiosantosfs6	fabiosantosfs6	7
dg_douglas12	dg_douglas12	7
mibrteam	mibrteam	7
vitorfbueno	vitorfbueno	7
cbf_futebol	cbf_futebol	7
vizeu9	vizeu9	7
22everton	22everton	7
raphaelveigaa	raphaelveigaa	7
muricyramalhoreal	muricyramalhoreal	7
99marrony	99marrony	7
gilzagueiro04	gilzagueiro04	7
bope.oficial	bope.oficial	7
lazaro_vinicius10	lazaro_vinicius10	7
brttoficial	brttoficial	7
fallen	fallen	7
marcosgoleiro_12	marcosgoleiro_12	7
fabiogoleirooficial	fabiogoleirooficial	7
gaules	gaules	7
corinthians	corinthians	7
cesarbernardo__	cesarbernardo__	7
ghenrique093	ghenrique093	7
tgalhardo	tgalhardo	7
saopaulofc	saopaulofc	7
antony00	antony00	7
williandubgod	williandubgod	7
lucianoneves18	lucianoneves18	7
gabriel	gabriel	7
marcosbrazoficial	marcosbrazoficial	7
flamengo	flamengo	7
michael19	michael19	7
pedrovictor38_	pedrovictor38_	7
_hugo99	_hugo99	7
bolsominionsarrependidos	bolsominionsarrependidos	7
seremosresistencia	seremosresistencia	7
ricardograu_	ricardograu_	7
saquinhodelixo	saquinhodelixo	7
puxoucortoueraspou	puxoucortoueraspou	7
guilhermeboulos.oficial	guilhermeboulos.oficial	7
lulaoficial	lulaoficial	7
edergrauu	edergrauu	7
palmeiras	palmeiras	7
vitordicastro	vitordicastro	7
pedroguilherme	pedroguilherme	7
pablomv5	pablomv5	7
aleoliveira	aleoliveira	7
lucaslima	lucaslima	7
oladobomdascoisas.oficial	oladobomdascoisas.oficial	7
emicida	emicida	7
romariofaria	romariofaria	7
g10dearrascaeta	g10dearrascaeta	7
domenectorrent	domenectorrent	7
pretitudes	pretitudes	7
thiago.maia	thiago.maia	7
patrick.dpaula99	patrick.dpaula99	7
rodrigocaio_	rodrigocaio_	7
jocalleri	jocalleri	7
vittinho	vittinho	7
lincondetona__	lincondetona__	7
feminiismo	feminiismo	7
manueladavila	manueladavila	7
crisrozeira	crisrozeira	7
pedrocardosoeumesmo	pedrocardosoeumesmo	7
jogoaberto	jogoaberto	7
leandro_assis_ilustra	leandro_assis_ilustra	7
tvafiada	tvafiada	7
folhadespaulo	folhadespaulo	7
haddaddebochado	haddaddebochado	7
alienigenasdofutebol	alienigenasdofutebol	7
futebolrei	futebolrei	7
luisfabianooficial	luisfabianooficial	7
natalyneri	natalyneri	7
coachabelferreira	coachabelferreira	7
brasileirao	brasileirao	7
pesmilgrau_	pesmilgrau_	7
lincoln9	lincoln9	7
fernandohaddadoficial	fernandohaddadoficial	7
igor.liziero	igor.liziero	7
gduvivier	gduvivier	7
igorgomes	igorgomes	7
caetanoveloso	caetanoveloso	7
ochicungunha	ochicungunha	7
matheuzinho.02	matheuzinho.02	7
martavsilva10	martavsilva10	7
reinaldosilva6	reinaldosilva6	7
robertharboleda4	robertharboleda4	7
zr11	zr11	7
osascorte	osascorte	7
josevitorleme	josevitorleme	7
costumacomgente	costumacomgente	7
gustavogomez462	gustavogomez462	7
doentesporfutebol	doentesporfutebol	7
luizadrianinho	luizadrianinho	7
jornalsensacionalista	jornalsensacionalista	7
gabrielveron	gabrielveron	7
problematizadoras	problematizadoras	7
desargumentacao	desargumentacao	7
18loboguerra	18loboguerra	7
weverton010	weverton010	7
galeano_antonio11	galeano_antonio11	7
motos_do_grau_oficial	motos_do_grau_oficial	7
fakenewsdofutebol	fakenewsdofutebol	7
djamilaribeiro1	djamilaribeiro1	7
davidmirandario	davidmirandario	7
g.noga	g.noga	7
zico	zico	7
andressaalves9oficial	andressaalves9oficial	7
oberrio28oficial	oberrio28oficial	7
rubronegromilgr4u	rubronegromilgr4u	7
burguesia.fede	burguesia.fede	7
theinterceptbrasil	theinterceptbrasil	7
anagrcs_	anagrcs_	7
luizaerundina	luizaerundina	7
parmeramilgrau	parmeramilgrau	7
urubugoalz	urubugoalz	7
marcelofreixo	marcelofreixo	7
flazoeiro_oficial	flazoeiro_oficial	7
todasfridasoficial	todasfridasoficial	7
spfcdazoeira	spfcdazoeira	7
spfcterra	spfcterra	7
guiadofuteboll	guiadofuteboll	7
luan08	luan08	7
pedrorocha32	pedrorocha32	7
enrolaocabo.ofc	enrolaocabo.ofc	7
m_thuler	m_thuler	7
saopaulo.milgrau	saopaulo.milgrau	7
netoputasso	netoputasso	7
estadao	estadao	7
mfutebolisticos	mfutebolisticos	7
gabrielmenino00	gabrielmenino00	7
belajogada	belajogada	7
moiseslima	moiseslima	7
cantadasprogressistas	cantadasprogressistas	7
nacaobrfla	nacaobrfla	7
luangarciaa	luangarciaa	7
diegocosta_99	diegocosta_99	7
umfilmemedisse	umfilmemedisse	7
marcoaureliooficial	marcoaureliooficial	7
humoresportivo.oficial	humoresportivo.oficial	7
marilia_nery	marilia_nery	7
rai10oficial	rai10oficial	7
eraldinho3	eraldinho3	7
barbaragol1	barbaragol1	7
dieegoalves01	dieegoalves01	7
pecuariabrasiloficial	pecuariabrasiloficial	7
minijogadoress	minijogadoress	7
somosasnetasdasbruxas	somosasnetasdasbruxas	7
boladeiros	boladeiros	7
marcosrocha2oficial	marcosrocha2oficial	7
jfeghali	jfeghali	7
j4juanoficial	j4juanoficial	7
rubro_negro_informa	rubro_negro_informa	7
gaveanews	gaveanews	7
renerodriguees	renerodriguees	7
obviousagency	obviousagency	7
pbr	pbr	7
oficial_formiga	oficial_formiga	7
flaraporiginal	flaraporiginal	7
ozopilote	ozopilote	7
eduardosuplicy	eduardosuplicy	7
bastidortricolor	bastidortricolor	7
sourubronegrodecoracao	sourubronegrodecoracao	7
laranjinha_013	laranjinha_013	7
brunoalves	brunoalves	7
imperiobr81	imperiobr81	7
futebolcenter_	futebolcenter_	7
futeousadoo	futeousadoo	7
samiabomfim	samiabomfim	7
junior_nogueira101	junior_nogueira101	7
ludmiladasilva09oficial	ludmiladasilva09oficial	7
artecromo	artecromo	7
wesley_ribeiro99	wesley_ribeiro99	7
opiortimeeoseu	opiortimeeoseu	7
cartacapital	cartacapital	7
gaveadepressiva_oficial	gaveadepressiva_oficial	7
zueirafutebolclube	zueirafutebolclube	7
menterubronegra	menterubronegra	7
tata_dias10	tata_dias10	7
camilinha94mp	camilinha94mp	7
salvespbr	salvespbr	7
pastorhenriquevieira	pastorhenriquevieira	7
titan160club	titan160club	7
viniciusharasjv	viniciusharasjv	7
11dagoberto	11dagoberto	7
imperio_da_nacao1895	imperio_da_nacao1895	7
alexandrevidalfotografo	alexandrevidalfotografo	7
einsteindabola	einsteindabola	7
vocelembradele	vocelembradele	7
jefersonfoguim	jefersonfoguim	7
venecasagrande	venecasagrande	7
laertegenial	laertegenial	7
lojasoficiaisdoflamengo	lojasoficiaisdoflamengo	7
nacao100limites	nacao100limites	7
golperdido	golperdido	7
debinhaa7	debinhaa7	7
biazaneratto	biazaneratto	7
drtannure	drtannure	7
leandroguerreirooficial	leandroguerreirooficial	7
onossopalestra	onossopalestra	7
spfcmiltretas	spfcmiltretas	7
vicalbuquerq	vicalbuquerq	7